utterance	output
来一首白居易的诗了。	[IN:QUERY 来一首[SL:AUTHOR 白居易]的诗了。]
中国教育电视台三台	[IN:PLAY [SL:NAME 中国教育电视台三台]]
来一首歌尔勤县	[IN:PLAY 来一首歌尔勤县]
尽在不言中下一句是什么？	[IN:QUERY [SL:KEYWORD 尽在不言中][SL:QUERYFIELD 下一句]是什么？]
中国霸王花	[IN:QUERY [SL:NAME 中国霸王花]]
打开索尼官方网站	[IN:OPEN 打开[SL:NAME 索尼]官方网站]
搜索逃学威龙第二部	[IN:QUERY 搜索[SL:NAME 逃学威龙][SL:SEASON 第二部]]
帮我找到去安徽黄山的路	[IN:ROUTE 帮我找到去[SL:ENDLOC_PROVINCE 安徽][SL:ENDLOC_POI 黄山]的路]
明天珠海到青岛的航班	[IN:QUERY [SL:STARTDATE_DATE 明天][SL:STARTLOC_CITY 珠海]到[SL:ENDLOC_CITY 青岛]的航班]
让我猜个谜语。	[IN:QUERY 让我猜个[SL:CATEGORY 谜语]。]
美国恐怖电影	[IN:QUERY [SL:AREA 美国][SL:TAG 恐怖][SL:CATEGORY 电影]]
温州到上海的车。	[IN:QUERY [SL:SRC 温州]到[SL:DEST 上海]的车。]
我现在要发一条信息	[IN:SEND 我现在要发一条信息]
查一下济南到成都的航班	[IN:QUERY 查一下[SL:STARTLOC_CITY 济南]到[SL:ENDLOC_CITY 成都]的航班]
干豆角怎么烧？	[IN:QUERY [SL:INGREDIENT 干豆角]怎么烧？]
附近有没有电影院啊？	[IN:QUERY 附近有没有电影院啊？]
我想知道今天的娱乐新闻。	[IN:PLAY 我想知道[SL:DATETIME_DATE 今天]的[SL:CATEGORY 娱乐]新闻。]
查一下苏州到洛阳的火车票	[IN:QUERY 查一下[SL:STARTLOC_CITY 苏州]到[SL:ENDLOC_CITY 洛阳]的火车票]
香蕉用英语怎么讲	[IN:TRANSLATION [SL:CONTENT 香蕉]用[SL:TARGET 英语]怎么讲]
冯沙排骨怎么做？	[IN:QUERY 冯沙[SL:INGREDIENT 排骨]怎么做？]
查询一下南方航空的股票	[IN:QUERY 查询一下[SL:NAME 南方航空]的股票]
虾炒蛋怎么做？	[IN:QUERY [SL:DISHNAME 虾炒蛋]怎么做？]
刘诗诗主演过的电影	[IN:QUERY [SL:ARTIST 刘诗诗][SL:ARTISTROLE 主演]过的[SL:CATEGORY 电影]]
小孩子有肺炎的治疗方法有哪些？	[IN:QUERY 小孩子有[SL:KEYWORD 肺炎]的治疗方法有哪些？]
麻辣烫做法。	[IN:QUERY [SL:DISHNAME 麻辣烫]做法。]
新蛋网	[IN:OPEN [SL:NAME 新蛋网]]
就拉下的饺子怎么做？	[IN:QUERY 就拉下的[SL:DISHNAME 饺子]怎么做？]
帮我搜索一下红烧排骨。	[IN:QUERY 帮我搜索一下[SL:DISHNAME 红烧排骨]。]
肾积水怎么治？	[IN:QUERY [SL:KEYWORD 肾积水]怎么治？]
买东西翻译成英语	[IN:TRANSLATION [SL:CONTENT 买东西]翻译成[SL:TARGET 英语]]
查看短消息	[IN:VIEW 查看短消息]
找下最近最热播的电影。	[IN:QUERY 找下最近最热播的电影。]
给许浩发一条短信	[IN:SEND 给[SL:NAME 许浩]发一条短信]
乳腺炎。	[IN:QUERY [SL:KEYWORD 乳腺炎]。]
糖尿病注意什么？	[IN:QUERY [SL:KEYWORD 糖尿病]注意什么？]
陈奕迅有什么歌啊	[IN:SEARCH [SL:ARTIST 陈奕迅]有什么歌啊]
今天新余到北京的航班	[IN:QUERY [SL:STARTDATE_DATE 今天][SL:STARTLOC_CITY 新余]到[SL:ENDLOC_CITY 北京]的航班]
那做红烧鱼需要哪些材料啊？	[IN:QUERY 那做[SL:DISHNAME 红烧鱼]需要哪些材料啊？]
扬州炒饭	[IN:QUERY [SL:DISHNAME 扬州炒饭]]
咳嗽怎么治？	[IN:QUERY [SL:KEYWORD 咳嗽]怎么治？]
背一首声声慢。	[IN:QUERY 背一首[SL:NAME 声声慢]。]
红烧鱼怎么烧啊？	[IN:QUERY [SL:DISHNAME 红烧鱼]怎么烧啊？]
帮我查一下从济南到福州的机票	[IN:QUERY 帮我查一下从[SL:STARTLOC_CITY 济南]到[SL:ENDLOC_CITY 福州]的机票]
北京国安的赛程。	[IN:QUERY [SL:NAME 北京国安]的赛程。]
收听中国人民广播电台广播	[IN:LAUNCH 收听[SL:NAME 中国人民广播电台广播]]
送黄炒鸡蛋怎么做？	[IN:QUERY 送黄[SL:DISHNAME 炒鸡蛋]怎么做？]
福建电视台	[IN:PLAY [SL:NAME 福建电视台]]
葱爆羊肉的做法。	[IN:QUERY [SL:DISHNAME 葱爆羊肉]的做法。]
等一下七点半湖南卫视会播出什么节目	[IN:QUERY 等一下[SL:DATETIME_TIME 七点半][SL:TVCHANNEL 湖南卫视]会播出什么节目]
来个最新新闻。	[IN:PLAY 来个[SL:KEYWORD 最新]新闻。]
现在有什么好看的电视剧吗？	[IN:QUERY [SL:DATETIME_TIME 现在]有什么好看的[SL:CATEGORY 电视剧]吗？]
给我查一下什么时间有播放天天向上	[IN:QUERY 给我查一下什么时间有播放[SL:NAME 天天向上]]
查询泉州到上海的动车票	[IN:QUERY 查询[SL:STARTLOC_CITY 泉州]到[SL:ENDLOC_CITY 上海]的[SL:CATEGORY 动车]票]
明天到合肥的火车	[IN:QUERY [SL:STARTDATE_DATE 明天]到[SL:ENDLOC_CITY 合肥]的火车]
请问意大利面怎么做	[IN:QUERY 请问[SL:DISHNAME 意大利面]怎么做]
查询福建电影院的热映电影	[IN:QUERY 查询[SL:THEATRE 福建电影院]的热映电影]
烤肉串。	[IN:QUERY [SL:DISHNAME 烤肉串]。]
打开苹果香港官方网站	[IN:OPEN 打开[SL:NAME 苹果香港官方网站]]
西红柿炒蛋怎么煮？	[IN:QUERY [SL:DISHNAME 西红柿炒蛋]怎么煮？]
打电话到飞云	[IN:DIAL 打电话到[SL:NAME 飞云]]
最近有什么好看的电视连续剧武打的。	[IN:QUERY [SL:TIMEDESCR 最近]有什么[SL:SCOREDESCR 好看]的[SL:CATEGORY 电视连续剧][SL:TAG 武打]的。]
给我随便来几首歌	[IN:PLAY 给我随便来几首歌]
请问红烧肉的做法？你，你。	[IN:QUERY 请问[SL:DISHNAME 红烧肉]的做法？你，你。]
打开搜狐新闻	[IN:LAUNCH 打开[SL:NAME 搜狐新闻]]
给金华打电话	[IN:DIAL 给[SL:NAME 金华]打电话]
搜搜一首毛泽东的诗。	[IN:QUERY 搜搜一首[SL:AUTHOR 毛泽东]的诗。]
打电话给陈雷	[IN:DIAL 打电话给[SL:NAME 陈雷]]
体育赛事直播	[IN:PLAY [SL:NAME 体育赛事]直播]
我要听还是会这首歌	[IN:PLAY 我要听[SL:SONG 还是会]这首歌]
给熊媛媛打电话	[IN:DIAL 给[SL:NAME 熊媛媛]打电话]
得了肝癌怎么办？	[IN:QUERY 得了[SL:KEYWORD 肝癌]怎么办？]
我想全部回复	[IN:REPLAY_ALL 我想全部回复]
怎么去泉城广场	[IN:ROUTE 怎么去[SL:ENDLOC_POI 泉城广场]]
搜索结束软件	[IN:QUERY 搜索[SL:NAME 结束]软件]
12月9日北京卫视节目单	[IN:QUERY [SL:DATETIME_DATE 12月9日][SL:TVCHANNEL 北京卫视]节目单]
今天温度是多少	[IN:QUERY [SL:DATETIME_DATE 今天][SL:SUBFOCUS 温度]是多少]
古惑仔	[IN:QUERY [SL:NAME 古惑仔]]
播放一首倒带来听一听	[IN:PLAY 播放一首[SL:SONG 倒带]来听一听]
湖南台演什么节目	[IN:QUERY [SL:TVCHANNEL 湖南台]演什么节目]
来一首夜夜夜	[IN:PLAY 来一首[SL:SONG 夜夜夜]]
茶用英语怎么说呀	[IN:TRANSLATION [SL:CONTENT 茶]用[SL:TARGET 英语]怎么说呀]
我昨天晚上的今日关注	[IN:QUERY 我[SL:DATETIME_DATE 昨天][SL:DATETIME_TIME 晚上]的[SL:NAME 今日关注]]
如何做芝麻糊。	[IN:QUERY 如何做[SL:DISHNAME 芝麻糊]。]
查询沿途的KTV	[IN:POSITION 查询沿途的[SL:LOCATION_POI KTV]]
你给我说几个谜语。	[IN:QUERY 你给我说几个[SL:CATEGORY 谜语]。]
中央电视台电影频道	[IN:PLAY [SL:NAME 中央电视台电影频道]]
我想听足球类新闻	[IN:PLAY 我想听[SL:CATEGORY 足球]类新闻]
打给孩子的爸	[IN:DIAL 打给[SL:NAME 孩子的爸]]
挑逗你真好玩儿英语怎么说	[IN:TRANSLATION [SL:CONTENT 挑逗你真好玩儿][SL:TARGET 英语]怎么说]
葫芦鸡怎么做？	[IN:QUERY [SL:DISHNAME 葫芦鸡]怎么做？]
北京到上海的火车票	[IN:QUERY [SL:STARTLOC_CITY 北京]到[SL:ENDLOC_CITY 上海]的火车票]
帮我查一下2013年2月8日开奖的七星彩中奖号码	[IN:NUMBER_QUERY 帮我查一下[SL:DATETIME_DATE 2013年2月8日]开奖的[SL:NAME 七星彩]中奖号码]
蛋黄焗薯条怎么做	[IN:QUERY [SL:DISHNAME 蛋黄焗薯条]怎么做]
从西安到石嘴山的汽车票。	[IN:QUERY 从[SL:SRC 西安]到[SL:DEST 石嘴山]的汽车票。]
上海到苏州	[IN:ROUTE [SL:STARTLOC_CITY 上海]到[SL:ENDLOC_CITY 苏州]]
满秋	[IN:QUERY [SL:NAME 满秋]]
人死原知万事空下一句是什么？	[IN:QUERY [SL:KEYWORD 人死原知万事空][SL:QUERYFIELD 下一句]是什么？]
鱼香茄子怎么做	[IN:QUERY [SL:DISHNAME 鱼香茄子]怎么做]
啥婆豆腐的制作方法	[IN:QUERY 啥婆[SL:INGREDIENT 豆腐]的制作方法]
给我讲个笑话吧，鱼香肉丝怎么做？	[IN:QUERY 给我讲个笑话吧，[SL:DISHNAME 鱼香肉丝]怎么做？]
播放特种兵之利刃出鞘	[IN:QUERY 播放[SL:NAME 特种兵之利刃出鞘]]
翻译睡觉了	[IN:TRANSLATION 翻译[SL:CONTENT 睡觉了]]
让读一下沁园春雪毛泽东。	[IN:QUERY 让读一下[SL:NAME 沁园春雪][SL:AUTHOR 毛泽东]。]
王菲传奇。	[IN:PLAY [SL:ARTIST 王菲][SL:SONG 传奇]。]
红烧土豆怎么烧？	[IN:QUERY [SL:DISHNAME 红烧土豆]怎么烧？]
上海到北京的飞机航班	[IN:QUERY [SL:STARTLOC_CITY 上海]到[SL:ENDLOC_CITY 北京]的飞机航班]
查询濮耐股份的股票	[IN:QUERY 查询[SL:NAME 濮耐股份]的股票]
我想听情花开这首歌	[IN:PLAY 我想听[SL:SONG 情花开]这首歌]
怎样蒸排骨最好吃的。	[IN:QUERY 怎样[SL:DISHNAME 蒸排骨]最好吃的。]
红烧排骨怎么做的吗？	[IN:QUERY [SL:DISHNAME 红烧排骨]怎么做的吗？]
到公园怎么走	[IN:ROUTE 到[SL:ENDLOC_POI 公园]怎么走]
导航到建八路	[IN:ROUTE 导航到[SL:ENDLOC_POI 建八路]]
爆炒猪肝怎么做？	[IN:QUERY [SL:DISHNAME 爆炒猪肝]怎么做？]
从武汉到杭州的火车	[IN:QUERY 从[SL:STARTLOC_CITY 武汉]到[SL:ENDLOC_CITY 杭州]的火车]
给谢小培发短信今晚一起吃饭	[IN:SEND 给[SL:NAME 谢小培]发短信[SL:CONTENT 今晚一起吃饭]]
菠萝包怎么做？	[IN:QUERY [SL:DISHNAME 菠萝包]怎么做？]
查询众乐电影院最热门的电影	[IN:QUERY 查询[SL:THEATRE 众乐电影院]最热门的电影]
发短信给张全三移动的号码我今天请他吃法	[IN:SEND 发短信给[SL:NAME 张全三][SL:TELEOPERATOR 移动]的号码[SL:CONTENT 我今天请他吃法]]
来一首咏柳。	[IN:QUERY 来一首[SL:NAME 咏柳]。]
我要发信息给高鹤航	[IN:SEND 我要发信息给[SL:NAME 高鹤航]]
陈娴TCL股票是涨还是跌了	[IN:RISERATE_QUERY 陈娴[SL:NAME TCL]股票是涨还是跌了]
给我写一个新邮件	[IN:CREATE 给我写一个新邮件]
查下温州到杭州的火车票	[IN:QUERY 查下[SL:STARTLOC_CITY 温州]到[SL:ENDLOC_CITY 杭州]的火车票]
北京生活频道节目单	[IN:QUERY [SL:TVCHANNEL 北京生活频道]节目单]
帮我看一下到科大讯飞最快的是哪条路线	[IN:ROUTE 帮我看一下到[SL:ENDLOC_POI 科大讯飞]最快的是哪条路线]
查询宜春到南昌的火车列车时刻表	[IN:QUERY 查询[SL:STARTLOC_CITY 宜春]到[SL:ENDLOC_CITY 南昌]的火车列车时刻表]
我想听蔡依林的倒带这首歌	[IN:PLAY 我想听[SL:ARTIST 蔡依林]的[SL:SONG 倒带]这首歌]
魔幻电影	[IN:QUERY [SL:TAG 魔幻][SL:CATEGORY 电影]]
请帮我调频89.7上虞人民广播电台	[IN:LAUNCH 请帮我调频[SL:CODE 89.7][SL:NAME 上虞人民广播电台]]
如何治疗脚气	[IN:QUERY 如何治疗[SL:KEYWORD 脚气]]
AXN	[IN:PLAY [SL:NAME AXN]]
说话的英文怎么写	[IN:TRANSLATION [SL:CONTENT 说话]的[SL:TARGET 英文]怎么写]
很想看安徽卫视来着	[IN:PLAY 很想看[SL:NAME 安徽卫视]来着]
呼叫晚欲强	[IN:DIAL 呼叫[SL:NAME 晚欲强]]
查一下今天早上的新闻。	[IN:PLAY 查一下[SL:DATETIME_DATE 今天][SL:DATETIME_TIME 早上]的新闻。]
坐宫保鸡丁需要哪些材料？	[IN:QUERY 坐[SL:DISHNAME 宫保鸡丁]需要哪些材料？]
怎样炒肉。	[IN:QUERY 怎样[SL:DISHNAME 炒肉]。]
陈真	[IN:QUERY [SL:NAME 陈真]]
今天杭州有什么新闻	[IN:PLAY [SL:DATETIME_DATE 今天][SL:LOCATION_CITY 杭州]有什么新闻]
美国最近有什么新闻	[IN:PLAY [SL:LOCATION_COUNTRY 美国][SL:DATETIME_DATE 最近]有什么新闻]
刘禹锡的秋词。	[IN:QUERY [SL:AUTHOR 刘禹锡]的[SL:NAME 秋词]。]
潜山到福州的火车	[IN:QUERY [SL:STARTLOC_AREA 潜山]到[SL:ENDLOC_CITY 福州]的火车]
给张金波发短消息今天中午一起吃饭	[IN:SEND 给[SL:NAME 张金波]发短消息[SL:CONTENT 今天中午一起吃饭]]
查看婷婷的号码	[IN:QUERY 查看[SL:NAME 婷婷]的号码]
教我怎么做红烧肉	[IN:QUERY 教我怎么做[SL:DISHNAME 红烧肉]]
来is，来一首采莲。	[IN:QUERY 来is，来一首[SL:NAME 采莲]。]
做红烧肉。	[IN:QUERY 做[SL:DISHNAME 红烧肉]。]
搜索东方卫视的电视节目。	[IN:QUERY 搜索[SL:TVCHANNEL 东方卫视]的电视节目。]
干锅排骨虾怎么做？	[IN:QUERY [SL:DISHNAME 干锅排骨][SL:INGREDIENT 虾]怎么做？]
篮球赛事预告。	[IN:QUERY [SL:CATEGORY 篮球]赛事[SL:TYPE 预告]。]
查个字谜。	[IN:QUERY 查个[SL:CATEGORY 字谜]。]
今晚看什么电影？	[IN:QUERY [SL:DATETIME_TIME 今晚]看什么[SL:CATEGORY 电影]？]
打开会说话的汤姆猫	[IN:LAUNCH 打开[SL:NAME 会说话的汤姆猫]]
山东高清	[IN:PLAY [SL:NAME 山东高清]]
烤鸡翅怎么做呀？	[IN:QUERY [SL:DISHNAME 烤鸡翅]怎么做呀？]
红烧肉怎么做？嗯？	[IN:QUERY [SL:DISHNAME 红烧肉]怎么做？嗯？]
查询合肥市植物园的位置	[IN:POSITION 查询[SL:LOCATION_POI 合肥市植物园]的位置]
我是特种兵二	[IN:QUERY [SL:NAME 我是特种兵二]]
查询广州到海南的航班	[IN:QUERY 查询[SL:STARTLOC_CITY 广州]到[SL:ENDLOC_CITY 海南]的航班]
请打开电影	[IN:QUERY 请打开[SL:CATEGORY 电影]]
又热炒鸡蛋怎么做？	[IN:QUERY 又热[SL:DISHNAME 炒鸡蛋]怎么做？]
腾讯股票昨日收盘价	[IN:CLOSEPRICE_QUERY [SL:NAME 腾讯]股票[SL:YESTERDAY 昨日]收盘价]
我要看唐家三少写的玄幻小说绝世唐门	[IN:QUERY 我要看[SL:AUTHOR 唐家三少]写的[SL:CATEGORY 玄幻]小说[SL:NAME 绝世唐门]]
乳腺癌。	[IN:QUERY [SL:KEYWORD 乳腺癌]。]
阑尾炎	[IN:QUERY [SL:KEYWORD 阑尾炎]]
图库	[IN:LAUNCH [SL:NAME 图库]]
可乐鸡翅是怎么做的	[IN:QUERY [SL:DISHNAME 可乐鸡翅]是怎么做的]
最近在播什么电影？	[IN:QUERY 最近在播什么电影？]
从新加坡花园怎么去宁溪路	[IN:ROUTE 从[SL:STARTLOC_POI 新加坡花园]怎么去[SL:ENDLOC_POI 宁溪路]]
阜阳到温州的航班	[IN:QUERY [SL:STARTLOC_CITY 阜阳]到[SL:ENDLOC_CITY 温州]的航班]
鲜肉玉米羹怎么做？	[IN:QUERY [SL:DISHNAME 鲜肉玉米羹]怎么做？]
打开浦发银行	[IN:OPEN 打开[SL:NAME 浦发银行]]
打电话麦亚伦	[IN:DIAL 打电话[SL:NAME 麦亚伦]]
一加一用英语怎么说	[IN:TRANSLATION [SL:CONTENT 一加一]用[SL:TARGET 英语]怎么说]
发短信给张三我明天去北京	[IN:SEND 发短信给[SL:NAME 张三][SL:CONTENT 我明天去北京]]
打电话给王安娜	[IN:DIAL 打电话给[SL:NAME 王安娜]]
中央电视台少儿频道大耳朵图图	[IN:QUERY [SL:TVCHANNEL 中央电视台少儿频道][SL:NAME 大耳朵图图]]
播放老婆最大。	[IN:PLAY 播放[SL:SONG 老婆最大]。]
我想看爱情闯进门	[IN:QUERY 我想看[SL:NAME 爱情闯进门]]
查询今天成都到北京的航班	[IN:QUERY 查询[SL:STARTDATE_DATE 今天][SL:STARTLOC_CITY 成都]到[SL:ENDLOC_CITY 北京]的航班]
贺岁片	[IN:QUERY [SL:TAG 贺岁][SL:CATEGORY 片]]
把哥哥的电话发给殷龙	[IN:SENDCONTACTS 把[SL:NAME 哥哥]的电话发给[SL:RECEIVER 殷龙]]
高清央视综艺	[IN:PLAY [SL:RESOLUTION 高清][SL:NAME 央视综艺]]
宁波到岳阳的汽车。	[IN:QUERY [SL:SRC 宁波]到[SL:DEST 岳阳]的汽车。]
打开uc浏览器登录新浪网主页	[IN:LAUNCH 打开[SL:NAME uc浏览器]登录新浪网主页]
帮我找首诗。	[IN:DEFAULT 帮我找首诗。]
关注一下今天的欧洲杯新闻	[IN:PLAY 关注一下[SL:DATETIME_DATE 今天]的[SL:KEYWORD 欧洲杯]新闻]
发送短信给老婆我在三号楼三零幺刚才那个教室关门了	[IN:SEND 发送短信给[SL:NAME 老婆][SL:CONTENT 我在三号楼三零幺刚才那个教室关门了]]
读句诗来听听。	[IN:DEFAULT 读句诗来听听。]
查询今天上海到成都的航班	[IN:QUERY 查询[SL:STARTDATE_DATE 今天][SL:STARTLOC_CITY 上海]到[SL:ENDLOC_CITY 成都]的航班]
电影频道明天放什么	[IN:QUERY [SL:TVCHANNEL 电影频道][SL:DATETIME_DATE 明天]放什么]
福尔摩探案急翻译成英文	[IN:TRANSLATION [SL:CONTENT 福尔摩探案急]翻译成[SL:TARGET 英文]]
打开应用漫画	[IN:LAUNCH 打开应用[SL:NAME 漫画]]
我想看变形金刚三	[IN:QUERY 我想看[SL:NAME 变形金刚三]]
厦门到福建建阳的火车是几点呢	[IN:QUERY [SL:STARTLOC_CITY 厦门]到[SL:ENDLOC_PROVINCE 福建][SL:ENDLOC_AREA 建阳]的火车是几点呢]
我要去姜堰	[IN:ROUTE 我要去[SL:ENDLOC_AREA 姜堰]]
想唱就唱	[IN:QUERY [SL:NAME 想唱就唱]]
播放眼色	[IN:PLAY 播放[SL:SONG 眼色]]
到环都大酒店怎么走	[IN:ROUTE 到[SL:ENDLOC_POI 环都大酒店]怎么走]
7月25号去上海的航班。	[IN:QUERY [SL:STARTDATE_DATE 7月25号]去[SL:ENDLOC_CITY 上海]的航班。]
罐焖牛肉怎么做？	[IN:QUERY 罐[SL:DISHNAME 焖牛肉]怎么做？]
搜索热门电影。	[IN:QUERY 搜索热门电影。]
CCTV四套	[IN:PLAY [SL:NAME CCTV四套]]
帮我打开电话本	[IN:LAUNCH 帮我打开[SL:NAME 电话本]]
讯飞语点请你搜索一下番茄炒蛋怎么做？	[IN:QUERY 讯飞语点请你搜索一下[SL:DISHNAME 番茄炒蛋]怎么做？]
杭州到上海	[IN:ROUTE [SL:STARTLOC_CITY 杭州]到[SL:ENDLOC_CITY 上海]]
中国新闻网网站	[IN:OPEN [SL:NAME 中国新闻网]网站]
从观音桥到重庆市图书馆怎么走	[IN:ROUTE 从[SL:STARTLOC_POI 观音桥]到[SL:ENDLOC_POI 重庆市图书馆]怎么走]
给我朗诵一下岳飞的满江红。	[IN:QUERY 给我朗诵一下[SL:AUTHOR 岳飞]的[SL:NAME 满江红]。]
导航到望江西路上去	[IN:ROUTE 导航到[SL:ENDLOC_POI 望江西路]上去]
大连飞往上海的航班	[IN:QUERY [SL:STARTLOC_CITY 大连]飞往[SL:ENDLOC_CITY 上海]的航班]
鱼香肉丝，怎么炒？	[IN:QUERY [SL:DISHNAME 鱼香肉丝]，怎么炒？]
发短信给子健晚上回家吃饭	[IN:SEND 发短信给[SL:NAME 子健][SL:CONTENT 晚上回家吃饭]]
上海申花的赛程。	[IN:QUERY [SL:NAME 上海申花]的赛程。]
到步行街不走高架的路线是哪条	[IN:ROUTE 到[SL:ENDLOC_POI 步行街]不走高架的路线是哪条]
我想今天新闻最近有什么新的新闻？	[IN:PLAY 我想[SL:DATETIME_DATE 今天]新闻最近有什么新的新闻？]
我去飞机场英语怎么说	[IN:TRANSLATION [SL:CONTENT 我去飞机场][SL:TARGET 英语]怎么说]
烤鸭，啊！	[IN:QUERY [SL:DISHNAME 烤鸭]，啊！]
带我去新都会	[IN:ROUTE 带我去[SL:ENDLOC_POI 新都会]]
找找三毛的爱情小说	[IN:QUERY 找找[SL:AUTHOR 三毛]的[SL:CATEGORY 爱情]小说]
把侨天慧的号码发给副卡	[IN:SENDCONTACTS 把[SL:NAME 侨天慧]的号码发给[SL:RECEIVER 副卡]]
桔子英文怎么说	[IN:TRANSLATION [SL:CONTENT 桔子][SL:TARGET 英文]怎么说]
看今天的新闻。	[IN:PLAY 看[SL:DATETIME_DATE 今天]的新闻。]
我想要转发这封邮件	[IN:FORWARD 我想要转发这封邮件]
北京西站在哪	[IN:POSITION [SL:LOCATION_POI 北京西站]在哪]
美国大使馆在哪	[IN:POSITION [SL:LOCATION_POI 美国大使馆]在哪]
陕西二套	[IN:PLAY [SL:NAME 陕西二套]]
打开聚划算网站	[IN:OPEN 打开[SL:NAME 聚划算]网站]
玄幻小说 幻神	[IN:QUERY [SL:CATEGORY 玄幻]小说 [SL:NAME 幻神]]
打开uc浏览器	[IN:LAUNCH 打开[SL:NAME uc浏览器]]
我要看功夫熊猫帮我播放出来	[IN:QUERY 我要看[SL:NAME 功夫熊猫]帮我播放出来]
打开河南英东网站	[IN:OPEN 打开[SL:NAME 河南英东]网站]
来点张艺谋出演的节目	[IN:QUERY 来点[SL:ARTIST 张艺谋][SL:ARTISTROLE 出演]的[SL:CATEGORY 节目]]
点播爱情买卖	[IN:PLAY 点播[SL:SONG 爱情买卖]]
我要看图文小说	[IN:QUERY 我要看[SL:CATEGORY 图文]小说]
小老虎用英语怎么讲	[IN:TRANSLATION [SL:CONTENT 小老虎]用[SL:TARGET 英语]怎么讲]
来个谜语吧！	[IN:QUERY 来个[SL:CATEGORY 谜语]吧！]
去红心中路怎么走	[IN:ROUTE 去[SL:ENDLOC_POI 红心中路]怎么走]
随便给我放几首歌	[IN:PLAY 随便给我放几首歌]
给我查下明天凌晨在放妈妈来了	[IN:QUERY 给我查下[SL:DATETIME_DATE 明天][SL:DATETIME_TIME 凌晨]在放[SL:NAME 妈妈来了]]
白切鸡怎么做啊？	[IN:QUERY [SL:DISHNAME 白切鸡]怎么做啊？]
人心无穷烧肉的做法。	[IN:QUERY 人心无穷[SL:DISHNAME 烧肉]的做法。]
搜一下小说。	[IN:QUERY 搜一下小说。]
给我来一首，相见恨晚的音乐。	[IN:PLAY 给我来一首，[SL:SONG 相见恨晚]的音乐。]
猪肉灌汤包怎么做？	[IN:QUERY [SL:DISHNAME 猪肉灌汤包]怎么做？]
扁豆豆角怎么烧？	[IN:QUERY 扁豆[SL:INGREDIENT 豆角]怎么烧？]
给我定一张株洲到深圳的机票	[IN:QUERY 给我定一张[SL:STARTLOC_CITY 株洲]到[SL:ENDLOC_CITY 深圳]的机票]
CCTV6电影高清	[IN:PLAY [SL:NAME CCTV6电影][SL:RESOLUTION 高清]]
我今天去北京了英语怎么说	[IN:TRANSLATION [SL:CONTENT 我今天去北京了][SL:TARGET 英语]怎么说]
搜索岳飞的诗满江红。	[IN:QUERY 搜索[SL:AUTHOR 岳飞]的诗[SL:NAME 满江红]。]
搜索机锋市场	[IN:QUERY 搜索[SL:NAME 机锋市场]]
冰糖雪梨	[IN:QUERY [SL:DISHNAME 冰糖雪梨]]
水饺的做法。	[IN:QUERY [SL:DISHNAME 水饺]的做法。]
自演艺，羊肉怎么做？	[IN:QUERY 自演艺，[SL:INGREDIENT 羊肉]怎么做？]
现在湖南卫视放什么电视？	[IN:QUERY [SL:DATETIME_TIME 现在][SL:TVCHANNEL 湖南卫视]放什么电视？]
福尔摩斯	[IN:QUERY [SL:NAME 福尔摩斯]]
看空霸	[IN:QUERY 看[SL:NAME 空霸]]
煮水饺。	[IN:QUERY 煮[SL:DISHNAME 水饺]。]
教我煮红烧排骨	[IN:QUERY 教我煮[SL:DISHNAME 红烧排骨]]
打开语音软件	[IN:LAUNCH 打开[SL:NAME 语音]软件]
济南去聊城的汽车。	[IN:QUERY [SL:SRC 济南]去[SL:DEST 聊城]的汽车。]
查找卢米埃银泰电影院有播放什么好看的电影吗	[IN:QUERY 查找[SL:THEATRE 卢米埃银泰电影院]有播放什么好看的电影吗]
请翻译苹果	[IN:TRANSLATION 请翻译[SL:CONTENT 苹果]]
打给曾玮文	[IN:DIAL 打给[SL:NAME 曾玮文]]
哦来一首忘情水	[IN:PLAY 哦来一首[SL:SONG 忘情水]]
红烧带鱼怎么做？你？	[IN:QUERY [SL:DISHNAME 红烧带鱼]怎么做？你？]
我叫小沈阳这首歌	[IN:PLAY [SL:SONG 我叫小沈阳]这首歌]
我要猜字谜不笨有答案。	[IN:QUERY 我要猜[SL:CATEGORY 字谜]不笨有答案。]
叶落长安电视剧	[IN:QUERY [SL:NAME 叶落长安][SL:CATEGORY 电视剧]]
帮我查一下苏州到上海的火车	[IN:QUERY 帮我查一下[SL:STARTLOC_CITY 苏州]到[SL:ENDLOC_CITY 上海]的火车]
皮冻的做法。	[IN:QUERY [SL:INGREDIENT 皮冻]的做法。]
从聊城到东营的车。	[IN:QUERY 从[SL:SRC 聊城]到[SL:DEST 东营]的车。]
那烤箱做面包怎么做？	[IN:QUERY 那烤箱做[SL:DISHNAME 面包]怎么做？]
李白的诗词	[IN:QUERY [SL:AUTHOR 李白]的诗词]
从长沙到北京的列车	[IN:QUERY 从[SL:STARTLOC_CITY 长沙]到[SL:ENDLOC_CITY 北京]的列车]
打电话给吴荣因	[IN:DIAL 打电话给[SL:NAME 吴荣因]]
前天中央一套的节目单	[IN:QUERY [SL:DATETIME_DATE 前天][SL:TVCHANNEL 中央一套]的节目单]
查看滁州到南京的火车票	[IN:QUERY 查看[SL:STARTLOC_CITY 滁州]到[SL:ENDLOC_CITY 南京]的火车票]
我想看变形金刚哦	[IN:QUERY 我想看[SL:NAME 变形金刚]哦]
发短信给王亮说死人你在干什么呢	[IN:SEND 发短信给[SL:NAME 王亮]说[SL:CONTENT 死人你在干什么呢]]
查询一下讯飞科大今天的股票	[IN:QUERY 查询一下[SL:NAME 讯飞科大]今天的股票]
中央电视台一套现在放什么节目？	[IN:QUERY [SL:TVCHANNEL 中央电视台一套][SL:DATETIME_TIME 现在]放什么节目？]
帮我查询一下温州到上海的火车	[IN:QUERY 帮我查询一下[SL:STARTLOC_CITY 温州]到[SL:ENDLOC_CITY 上海]的火车]
爱在旅途	[IN:QUERY [SL:NAME 爱在旅途]]
有你才幸福	[IN:QUERY [SL:NAME 有你才幸福]]
腰花可以怎么做？	[IN:QUERY [SL:INGREDIENT 腰花]可以怎么做？]
沙眼。	[IN:QUERY [SL:KEYWORD 沙眼]。]
甘肃台	[IN:PLAY [SL:NAME 甘肃台]]
亚洲能源物流股票	[IN:QUERY [SL:NAME 亚洲能源物流]股票]
现在电影院有什么好电影？	[IN:QUERY [SL:DATETIME_TIME 现在]电影院有什么好电影？]
请搜电影画皮	[IN:QUERY 请搜[SL:CATEGORY 电影][SL:NAME 画皮]]
打电话给一十一	[IN:DIAL 打电话给[SL:NAME 一十一]]
我要看免费的小说。	[IN:QUERY 我要看免费的小说。]
凉拌海蜇怎么做好吃？	[IN:QUERY [SL:DISHNAME 凉拌海蜇]怎么做好吃？]
打电话给阿华	[IN:DIAL 打电话给[SL:NAME 阿华]]
我想打电话给李四	[IN:DIAL 我想打电话给[SL:NAME 李四]]
宁波机场在哪里	[IN:POSITION [SL:LOCATION_CITY 宁波][SL:LOCATION_POI 机场]在哪里]
江苏党校二套	[IN:PLAY [SL:NAME 江苏党校二套]]
回锅肉做法。	[IN:QUERY [SL:DISHNAME 回锅肉]做法。]
香蕉的英语怎么说	[IN:TRANSLATION [SL:CONTENT 香蕉]的[SL:TARGET 英语]怎么说]
拨打张月华的电话	[IN:DIAL 拨打[SL:NAME 张月华]的电话]
济宁到潍坊的，车。	[IN:QUERY [SL:SRC 济宁]到[SL:DEST 潍坊]的，车。]
给茵茵发短信	[IN:SEND 给[SL:NAME 茵茵]发短信]
给杨凯发短信	[IN:SEND 给[SL:NAME 杨凯]发短信]
酸菜粉条肉的做法。	[IN:QUERY [SL:DISHNAME 酸菜粉条][SL:INGREDIENT 肉]的做法。]
搜索武汉到南京的机票	[IN:QUERY 搜索[SL:STARTLOC_CITY 武汉]到[SL:ENDLOC_CITY 南京]的机票]
明天去深圳的飞机	[IN:QUERY [SL:STARTDATE_DATE 明天]去[SL:ENDLOC_CITY 深圳]的飞机]
找深圳卫视	[IN:PLAY 找[SL:NAME 深圳卫视]]
明天温州到上海的航班。	[IN:QUERY [SL:STARTDATE_DATE 明天][SL:STARTLOC_CITY 温州]到[SL:ENDLOC_CITY 上海]的航班。]
播放音乐喜帖街。	[IN:PLAY 播放音乐[SL:SONG 喜帖街]。]
来首快乐崇拜	[IN:PLAY 来首[SL:SONG 快乐崇拜]]
给王帅发个短信说他让他起来尿尿	[IN:SEND 给[SL:NAME 王帅]发个短信说他[SL:CONTENT 让他起来尿尿]]
我想看张艺谋导演的电影	[IN:QUERY 我想看[SL:ARTIST 张艺谋][SL:ARTISTROLE 导演]的[SL:CATEGORY 电影]]
满园花菊郁金黄的下一句是什么？	[IN:QUERY [SL:KEYWORD 满园花菊郁金黄]的[SL:QUERYFIELD 下一句]是什么？]
田螺怎么炒啊？	[IN:QUERY [SL:INGREDIENT 田螺]怎么炒啊？]
酸菜鱼怎么做啊	[IN:QUERY [SL:DISHNAME 酸菜鱼]怎么做啊]
来首李白的诗集。	[IN:QUERY 来首[SL:AUTHOR 李白]的诗集。]
背离骚给我听。	[IN:QUERY 背[SL:NAME 离骚]给我听。]
帮我搜一下科大讯飞在哪	[IN:POSITION 帮我搜一下[SL:LOCATION_POI 科大讯飞]在哪]
我要看云南二台	[IN:PLAY 我要看[SL:NAME 云南二台]]
查一下新闻。	[IN:PLAY 查一下新闻。]
做南瓜饭	[IN:QUERY 做[SL:DISHNAME 南瓜饭]]
星期天早晨我们一起去打篮球英语怎么说	[IN:TRANSLATION [SL:CONTENT 星期天早晨我们一起去打篮球][SL:TARGET 英语]怎么说]
打个谜语吧！	[IN:QUERY 打个[SL:CATEGORY 谜语]吧！]
CCTV-5节目表	[IN:QUERY [SL:TVCHANNEL CCTV-5]节目表]
封神太子	[IN:LAUNCH [SL:NAME 封神太子]]
从南昌到长沙的汽车。	[IN:QUERY 从[SL:SRC 南昌]到[SL:DEST 长沙]的汽车。]
我要购买七乐彩	[IN:NUMBER_QUERY 我要购买[SL:NAME 七乐彩]]
背首绝句的。	[IN:QUERY 背首[SL:NAME 绝句]的。]
我想查询上证指数的股票	[IN:QUERY 我想查询[SL:NAME 上证指数]的股票]
查雷神电影	[IN:QUERY 查[SL:NAME 雷神][SL:CATEGORY 电影]]
笑话用英语怎么说	[IN:TRANSLATION [SL:CONTENT 笑话]用[SL:TARGET 英语]怎么说]
我想亲亲我的宝贝这首歌	[IN:PLAY 我想[SL:SONG 亲亲我的宝贝]这首歌]
来一首钟汉良的视觉动物	[IN:PLAY 来一首[SL:ARTIST 钟汉良]的[SL:SONG 视觉动物]]
狐臭怎么治？	[IN:QUERY [SL:KEYWORD 狐臭]怎么治？]
干贝怎么做？	[IN:QUERY [SL:INGREDIENT 干贝]怎么做？]
这个新闻有意思吗	[IN:PLAY 这个新闻有意思吗]
科大讯飞昨日成交价	[IN:QUERY [SL:NAME 科大讯飞][SL:YESTERDAY 昨日]成交价]
我想听星月神话	[IN:PLAY 我想听[SL:SONG 星月神话]]
开封到信阳的火车	[IN:QUERY [SL:STARTLOC_CITY 开封]到[SL:ENDLOC_CITY 信阳]的火车]
截止目前银鸽投资股份的市值是多少	[IN:QUERY 截止目前[SL:NAME 银鸽投资]股份的市值是多少]
搞笑谜语。	[IN:QUERY [SL:CATEGORY 搞笑谜语]。]
中华军事网	[IN:OPEN [SL:NAME 中华军事网]]
更年期综合症。	[IN:QUERY [SL:KEYWORD 更年期综合症]。]
有什么特色美食。	[IN:QUERY 有什么[SL:KEYWORD 特色美食]。]
看当前直播的比赛	[IN:QUERY 看当前直播的[SL:CATEGORY 比赛]]
特莫文蔚的阴天。	[IN:PLAY 特[SL:ARTIST 莫文蔚]的[SL:SONG 阴天]。]
土豆的做法	[IN:QUERY [SL:INGREDIENT 土豆]的做法]
我说铁锅炖羊肉怎么做？	[IN:QUERY 我说[SL:UTENSIL 铁锅][SL:DISHNAME 炖羊肉]怎么做？]
用英语怎么讲	[IN:TRANSLATION [SL:CONTENT 用][SL:TARGET 英语]怎么讲]
我想出去旅游英文怎么说	[IN:TRANSLATION [SL:CONTENT 我想出去旅游][SL:TARGET 英文]怎么说]
要看名侦探柯南	[IN:QUERY 要看[SL:NAME 名侦探柯南]]
我想听只对你有感觉	[IN:PLAY 我想听[SL:SONG 只对你有感觉]]
有什么好看的校园小说	[IN:QUERY 有什么[SL:POPULARITY 好看]的[SL:CATEGORY 校园]小说]
广西电视台现在播放什么节目？	[IN:QUERY [SL:TVCHANNEL 广西电视台][SL:DATETIME_TIME 现在]播放什么节目？]
回锅肉怎么做啊	[IN:QUERY [SL:DISHNAME 回锅肉]怎么做啊]
我要看热门电影。	[IN:QUERY 我要看热门电影。]
调到新疆综艺	[IN:PLAY 调到[SL:NAME 新疆综艺]]
我想看爱在春天	[IN:QUERY 我想看[SL:NAME 爱在春天]]
青春期撞上更年期二	[IN:QUERY [SL:NAME 青春期撞上更年期二]]
去烟台的火车	[IN:QUERY 去[SL:ENDLOC_CITY 烟台]的火车]
翻译慷慨激昂	[IN:TRANSLATION 翻译[SL:CONTENT 慷慨激昂]]
北京烤鸭做法。	[IN:QUERY [SL:DISHNAME 北京烤鸭]做法。]
查寻上海能源的股票	[IN:QUERY 查寻[SL:NAME 上海能源]的股票]
最近下午有什么电影？	[IN:QUERY 最近[SL:DATETIME_TIME 下午]有什么[SL:CATEGORY 电影]？]
带我去丹阳市眼镜市场	[IN:ROUTE 带我去[SL:ENDLOC_AREA 丹阳]市[SL:ENDLOC_POI 眼镜市场]]
李白的静夜思怎么读？	[IN:QUERY [SL:AUTHOR 李白]的[SL:NAME 静夜思]怎么读？]
给查乐发短信	[IN:SEND 给[SL:NAME 查乐]发短信]
合肥到上海可以到哪坐车？	[IN:QUERY [SL:SRC 合肥]到[SL:DEST 上海]可以到哪坐车？]
查询神鬼认证	[IN:QUERY 查询[SL:NAME 神鬼认证]]
哪里香我来一首李白的诗。	[IN:QUERY 哪里香我来一首[SL:AUTHOR 李白]的诗。]
心术电影	[IN:QUERY [SL:NAME 心术][SL:CATEGORY 电影]]
来一首七言绝句。	[IN:DEFAULT 来一首七言绝句。]
查询下北京首创的股票	[IN:QUERY 查询下[SL:NAME 北京首创]的股票]
查看双色球开奖	[IN:NUMBER_QUERY 查看[SL:NAME 双色球]开奖]
给黄卫国发短信	[IN:SEND 给[SL:NAME 黄卫国]发短信]
最近热门的电影。	[IN:QUERY 最近热门的电影。]
广东省英德在哪里	[IN:POSITION [SL:LOCATION_PROVINCE 广东省][SL:LOCATION_AREA 英德]在哪里]
歧路兄弟	[IN:QUERY [SL:NAME 歧路兄弟]]
科教频道	[IN:PLAY [SL:CATEGORY 科教]频道]
五号特工组	[IN:QUERY [SL:NAME 五号特工组]]
儋州到海口的航班	[IN:QUERY [SL:STARTLOC_AREA 儋州]到[SL:ENDLOC_CITY 海口]的航班]
你酸辣土豆丝怎么做？	[IN:QUERY 你[SL:DISHNAME 酸辣土豆丝]怎么做？]
帮我查一下今天开奖的15选5	[IN:NUMBER_QUERY 帮我查一下[SL:DATETIME_DATE 今天]开奖的[SL:NAME 15选5]]
东营到济南的航班	[IN:QUERY [SL:STARTLOC_CITY 东营]到[SL:ENDLOC_CITY 济南]的航班]
秦皇岛今天有什么新闻	[IN:PLAY [SL:LOCATION_CITY 秦皇岛][SL:DATETIME_DATE 今天]有什么新闻]
电视剧粘豆包	[IN:QUERY [SL:CATEGORY 电视剧][SL:NAME 粘豆包]]
凉皮的制作方法。	[IN:QUERY [SL:DISHNAME 凉皮]的制作方法。]
豆豉鲮鱼油麦菜	[IN:QUERY [SL:DISHNAME 豆豉鲮鱼油麦菜]]
前列腺炎该怎么治？	[IN:QUERY [SL:KEYWORD 前列腺炎]该怎么治？]
我给我念一首李白的诗吧？	[IN:QUERY 我给我念一首[SL:AUTHOR 李白]的诗吧？]
湖北电视台	[IN:PLAY [SL:NAME 湖北电视台]]
你曾爱过我吗用英语怎么说	[IN:TRANSLATION [SL:CONTENT 你曾爱过我吗]用[SL:TARGET 英语]怎么说]
哪个台在放甄嬛	[IN:QUERY 哪个台在放[SL:NAME 甄嬛]]
合肥到深圳的火车票	[IN:QUERY [SL:STARTLOC_CITY 合肥]到[SL:ENDLOC_CITY 深圳]的火车票]
我要操虾米的做法。	[IN:QUERY 我要操[SL:INGREDIENT 虾米]的做法。]
今天湖南卫视的电子节目单	[IN:QUERY [SL:DATETIME_DATE 今天][SL:TVCHANNEL 湖南卫视]的电子节目单]
查询标准股份的股票	[IN:QUERY 查询[SL:NAME 标准股份]的股票]
看电影啊	[IN:QUERY 看[SL:CATEGORY 电影]啊]
我想到科大讯飞走高速路线	[IN:ROUTE 我想到[SL:ENDLOC_POI 科大讯飞]走高速路线]
索尼爱立信官网	[IN:OPEN [SL:NAME 索尼爱立信]官网]
背一首春晓	[IN:QUERY 背一首[SL:NAME 春晓]]
从东莞去北海的汽车。	[IN:QUERY 从[SL:SRC 东莞]去[SL:DEST 北海]的汽车。]
搜索电视剧爱情悠悠药草香在哪个频道首播？	[IN:QUERY 搜索[SL:CATEGORY 电视剧][SL:NAME 爱情悠悠药草香]在哪个频道首播？]
早上好英语怎么讲	[IN:TRANSLATION [SL:CONTENT 早上好][SL:TARGET 英语]怎么讲]
高清央视综合频道	[IN:PLAY [SL:RESOLUTION 高清][SL:NAME 央视综合频道]]
基尾虾怎么做？	[IN:QUERY [SL:INGREDIENT 基尾虾]怎么做？]
油焖大虾怎么做	[IN:QUERY [SL:DISHNAME 油焖大虾]怎么做]
怎么样煮方便面。	[IN:QUERY 怎么样[SL:DISHNAME 煮方便面]。]
怎么做番茄炒蛋？	[IN:QUERY 怎么做[SL:DISHNAME 番茄炒蛋]？]
了，鸡蛋怎么做？	[IN:QUERY 了，[SL:INGREDIENT 鸡蛋]怎么做？]
发信息给陈明哲	[IN:SEND 发信息给[SL:NAME 陈明哲]]
鱼肉怎么做？	[IN:QUERY [SL:INGREDIENT 鱼肉]怎么做？]
河北在哪里	[IN:POSITION [SL:LOCATION_PROVINCE 河北]在哪里]
广州恒大比赛比分。	[IN:QUERY [SL:NAME 广州恒大]比赛[SL:TYPE 比分]。]
我说白鱼怎么做	[IN:QUERY 我说[SL:INGREDIENT 白鱼]怎么做]
臭豆腐汤怎么烧？	[IN:QUERY [SL:DISHNAME 臭豆腐汤]怎么烧？]
拨号曹兴发	[IN:DIAL 拨号[SL:NAME 曹兴发]]
世界地理的节目单	[IN:QUERY [SL:TVCHANNEL 世界地理]的节目单]
肩周炎怎么治？	[IN:QUERY [SL:KEYWORD 肩周炎]怎么治？]
合肥到芜湖的火车票	[IN:QUERY [SL:STARTLOC_CITY 合肥]到[SL:ENDLOC_CITY 芜湖]的火车票]
造化钟神秀的下一句是什么？	[IN:QUERY [SL:KEYWORD 造化钟神秀]的[SL:QUERYFIELD 下一句]是什么？]
发信息给熊伟	[IN:SEND 发信息给[SL:NAME 熊伟]]
深圳到开封的火车	[IN:QUERY [SL:STARTLOC_CITY 深圳]到[SL:ENDLOC_CITY 开封]的火车]
八月一号去上海的航班	[IN:QUERY [SL:STARTDATE_DATE 八月一号]去[SL:ENDLOC_CITY 上海]的航班]
湿疹怎么处理？	[IN:QUERY [SL:KEYWORD 湿疹]怎么处理？]
红烧肉的做法啊！	[IN:QUERY [SL:DISHNAME 红烧肉]的做法啊！]
宫崎骏动画电影	[IN:QUERY [SL:ARTIST 宫崎骏][SL:TAG 动画][SL:CATEGORY 电影]]
我想看中央十三频道	[IN:PLAY 我想看[SL:NAME 中央十三频道]]
金鹰卡通今天晚上放什么节目？	[IN:QUERY [SL:TVCHANNEL 金鹰卡通][SL:DATETIME_DATE 今天][SL:DATETIME_TIME 晚上]放什么节目？]
你好请问一下明天广州的天气如何	[IN:QUERY 你好请问一下[SL:DATETIME_DATE 明天][SL:LOCATION_CITY 广州]的天气如何]
把平水相逢的手机号码发给8000	[IN:SENDCONTACTS 把[SL:NAME 平水相逢]的[SL:CATEGORY 手机]号码发给[SL:RECEIVER 8000]]
上海宝钢股票	[IN:QUERY 上海[SL:NAME 宝钢]股票]
再猜一个谜语。	[IN:QUERY 再猜一个[SL:CATEGORY 谜语]。]
刑侦电视剧	[IN:QUERY [SL:TAG 刑侦][SL:CATEGORY 电视剧]]
给潘开国发短信	[IN:SEND 给[SL:NAME 潘开国]发短信]
咖喱牛腩怎么做	[IN:QUERY [SL:DISHNAME 咖喱牛腩]怎么做]
给于海洋发短信	[IN:SEND 给[SL:NAME 于海洋]发短信]
青春四十	[IN:QUERY [SL:NAME 青春四十]]
都市言情小说何以笙箫默	[IN:QUERY [SL:CATEGORY 都市言情]小说[SL:NAME 何以笙箫默]]
糖醋藕怎么做？	[IN:QUERY [SL:DISHNAME 糖醋藕]怎么做？]
椒盐排骨怎么做？你？	[IN:QUERY [SL:DISHNAME 椒盐排骨]怎么做？你？]
帮我查一下广州到长沙的航班	[IN:QUERY 帮我查一下[SL:STARTLOC_CITY 广州]到[SL:ENDLOC_CITY 长沙]的航班]
我想听忐忑这首歌打	[IN:PLAY 我想听[SL:SONG 忐忑]这首歌打]
开网页	[IN:OPEN 开网页]
查一下明天合肥到北京的航班。	[IN:QUERY 查一下[SL:STARTDATE_DATE 明天][SL:STARTLOC_CITY 合肥]到[SL:ENDLOC_CITY 北京]的航班。]
如何做西红柿炒蛋。	[IN:QUERY 如何做[SL:DISHNAME 西红柿炒蛋]。]
盘锦新闻。	[IN:PLAY [SL:LOCATION_CITY 盘锦]新闻。]
嘉禾电影院正在上映的大片	[IN:QUERY [SL:THEATRE 嘉禾电影院]正在上映的大片]
打电话给斌少	[IN:DIAL 打电话给[SL:NAME 斌少]]
帮我链接到新浪网	[IN:OPEN 帮我链接到[SL:NAME 新浪网]]
上一期双色球开什么	[IN:NUMBER_QUERY [SL:RELISSUE 上一期][SL:NAME 双色球]开什么]
然后等你杀猪菜怎么做？	[IN:QUERY 然后等你[SL:DISHNAME 杀猪菜]怎么做？]
中国石化的股票是涨还是跌	[IN:RISERATE_QUERY [SL:NAME 中国石化]的股票是涨还是跌]
背诵唐诗三百首静夜思。	[IN:QUERY 背诵[SL:DYNASTY 唐]诗三百首[SL:NAME 静夜思]。]
在线观看中央七套	[IN:PLAY 在线观看[SL:NAME 中央七套]]
中超A组比赛结果分别是多少	[IN:QUERY [SL:CATEGORY 中超]A组比赛[SL:TYPE 结果]分别是多少]
查一下运城到临汾的汽车。	[IN:QUERY 查一下[SL:SRC 运城]到[SL:DEST 临汾]的汽车。]
人民公园在哪里	[IN:POSITION [SL:LOCATION_POI 人民公园]在哪里]
富瑞特装股票	[IN:QUERY [SL:NAME 富瑞特装]股票]
来一首隐形的翅膀。	[IN:PLAY 来一首[SL:SONG 隐形的翅膀]。]
翻译今天出去玩	[IN:TRANSLATION 翻译[SL:CONTENT 今天出去玩]]
CCTV少儿	[IN:PLAY [SL:NAME CCTV少儿]]
山东台高清	[IN:PLAY [SL:NAME 山东台][SL:RESOLUTION 高清]]
肥肠的做法	[IN:QUERY [SL:INGREDIENT 肥肠]的做法]
发信息给苏建江	[IN:SEND 发信息给[SL:NAME 苏建江]]
搜索兰陵王。	[IN:QUERY 搜索[SL:NAME 兰陵王]。]
我想听，新闻。	[IN:PLAY 我想听，新闻。]
晋江到温州的火车票	[IN:QUERY [SL:STARTLOC_AREA 晋江]到[SL:ENDLOC_CITY 温州]的火车票]
把唐玉明的手机号码发给李康	[IN:SENDCONTACTS 把[SL:NAME 唐玉明]的[SL:CATEGORY 手机]号码发给[SL:RECEIVER 李康]]
二十五日去深圳的航班	[IN:QUERY [SL:STARTDATE_DATE 二十五日]去[SL:ENDLOC_CITY 深圳]的航班]
求米线怎么做？	[IN:QUERY 求[SL:INGREDIENT 米线]怎么做？]
读一首毛泽东的诗。	[IN:QUERY 读一首[SL:AUTHOR 毛泽东]的诗。]
朗读游子吟。	[IN:QUERY 朗读[SL:NAME 游子吟]。]
得了灰指甲怎么办？	[IN:QUERY 得了[SL:KEYWORD 灰指甲]怎么办？]
帮我查查北京电视台-6上周六开始美味的想念呢	[IN:QUERY 帮我查查[SL:TVCHANNEL 北京电视台-6][SL:DATETIME_DATE 上周六]开始[SL:NAME 美味的想念]呢]
青瓷电视剧	[IN:QUERY [SL:NAME 青瓷][SL:CATEGORY 电视剧]]
醉虾的做法。	[IN:QUERY [SL:DISHNAME 醉虾]的做法。]
我要看中央五台	[IN:PLAY 我要看[SL:NAME 中央五台]]
CCTV-10的百家讲坛	[IN:QUERY [SL:TVCHANNEL CCTV-10]的[SL:NAME 百家讲坛]]
蛋炒饭怎么煮	[IN:QUERY [SL:DISHNAME 蛋炒饭]怎么煮]
艺轩电影院最近上映的电影有哪些	[IN:QUERY [SL:THEATRE 艺轩电影院]最近上映的电影有哪些]
爱情工寓	[IN:QUERY [SL:NAME 爱情工寓]]
导航去科大讯飞	[IN:ROUTE 导航去[SL:ENDLOC_POI 科大讯飞]]
需要你帮我推荐一下电影	[IN:QUERY 需要你帮我推荐一下[SL:CATEGORY 电影]]
海棉宝宝	[IN:QUERY [SL:NAME 海棉宝宝]]
今天的新闻，欲	[IN:PLAY [SL:DATETIME_DATE 今天]的新闻，欲]
切换上海频道	[IN:PLAY 切换[SL:NAME 上海频道]]
小破孩动画片	[IN:QUERY [SL:NAME 小破孩][SL:TAG 动画][SL:CATEGORY 片]]
蝎子王蝎子王	[IN:QUERY [SL:NAME 蝎子王][SL:NAME 蝎子王]]
武汉到北京的飞机票	[IN:QUERY [SL:STARTLOC_CITY 武汉]到[SL:ENDLOC_CITY 北京]的飞机票]
今天我要去逛街用英语说	[IN:TRANSLATION [SL:CONTENT 今天我要去逛街]用[SL:TARGET 英语]说]
中国合伙人	[IN:QUERY [SL:NAME 中国合伙人]]
日本豆腐的做法。	[IN:QUERY [SL:INGREDIENT 日本豆腐]的做法。]
杭州南站到龙游的火车有哪几班	[IN:QUERY [SL:STARTLOC_POI 杭州南站]到[SL:ENDLOC_AREA 龙游]的火车有哪几班]
帮我看一下明天去北京的飞机	[IN:QUERY 帮我看一下[SL:STARTDATE_DATE 明天]去[SL:ENDLOC_CITY 北京]的飞机]
午夜凶铃	[IN:QUERY [SL:NAME 午夜凶铃]]
古诗长恨歌。	[IN:QUERY 古诗[SL:NAME 长恨歌]。]
面条怎么样煮啊？	[IN:QUERY [SL:INGREDIENT 面条]怎么样煮啊？]
公交查询	[IN:LAUNCH [SL:NAME 公交查询]]
黑芝麻怎么炒？	[IN:QUERY [SL:INGREDIENT 黑芝麻]怎么炒？]
芒果西米露怎么做啊	[IN:QUERY [SL:DISHNAME 芒果西米露]怎么做啊]
淋病怎么办	[IN:QUERY [SL:KEYWORD 淋病]怎么办]
收看安徽卫视节目。	[IN:QUERY 收看[SL:TVCHANNEL 安徽卫视]节目。]
讲个笑话吗	[IN:QUERY 讲个笑话吗]
我说吃飞蟹，怎么做？	[IN:QUERY 我说吃[SL:INGREDIENT 飞蟹]，怎么做？]
听听新闻。	[IN:PLAY 听听新闻。]
进入设置菜单	[IN:LAUNCH 进入[SL:NAME 设置]菜单]
帮我查一下淮安到石家庄的火车	[IN:QUERY 帮我查一下[SL:STARTLOC_CITY 淮安]到[SL:ENDLOC_CITY 石家庄]的火车]
打开网页小米论坛	[IN:OPEN 打开网页[SL:NAME 小米论坛]]
给我看邮件	[IN:LAUNCH 给我看邮件]
上海到合肥可以到哪坐车	[IN:QUERY [SL:SRC 上海]到[SL:DEST 合肥]可以到哪坐车]
打开相机我想你	[IN:LAUNCH 打开[SL:NAME 相机]我想你]
金山词霸	[IN:LAUNCH [SL:NAME 金山词霸]]
我要查找雷迪波尔电影院最新上映的大片	[IN:QUERY 我要查找[SL:THEATRE 雷迪波尔电影院]最新上映的大片]
宏达高科的股票跌了没有	[IN:RISERATE_QUERY [SL:NAME 宏达高科]的股票跌了没有]
2013年中国男足，主要赛程。	[IN:QUERY [SL:DATETIME_DATE 2013年][SL:CATEGORY 中国男足]，主要赛程。]
来个字谜我猜一下。	[IN:QUERY 来个[SL:CATEGORY 字谜]我猜一下。]
广州到南宁的火车	[IN:QUERY [SL:STARTLOC_CITY 广州]到[SL:ENDLOC_CITY 南宁]的火车]
中国石化的股价怎么样	[IN:QUERY [SL:NAME 中国石化]的股价怎么样]
来首苏轼的词。	[IN:QUERY 来首[SL:AUTHOR 苏轼]的词。]
给黄尚君发短信	[IN:SEND 给[SL:NAME 黄尚君]发短信]
知青	[IN:QUERY [SL:NAME 知青]]
四喜丸子怎么做？	[IN:QUERY [SL:DISHNAME 四喜丸子]怎么做？]
飞机场怎么走	[IN:ROUTE [SL:ENDLOC_POI 飞机场]怎么走]
你去哪用英文怎么说	[IN:TRANSLATION [SL:CONTENT 你去哪]用[SL:TARGET 英文]怎么说]
爱在何方第三期	[IN:QUERY [SL:NAME 爱在何方][SL:EPISODE 第三期]]
蓝精灵电影	[IN:QUERY [SL:NAME 蓝精灵][SL:CATEGORY 电影]]
给孟南发短信	[IN:SEND 给[SL:NAME 孟南]发短信]
我要听个新闻。	[IN:PLAY 我要听个新闻。]
白萝卜汤怎么做？	[IN:QUERY [SL:DISHNAME 白萝卜汤]怎么做？]
所以查学西宁特钢的股票	[IN:QUERY 所以查学[SL:NAME 西宁特钢]的股票]
烤鸡翅怎么做？	[IN:QUERY [SL:DISHNAME 烤鸡翅]怎么做？]
罗顿发展的股票	[IN:QUERY [SL:NAME 罗顿发展]的股票]
汉武大帝	[IN:QUERY [SL:NAME 汉武大帝]]
抽刀断水水更流的下一句是什么？	[IN:QUERY [SL:KEYWORD 抽刀断水水更流]的[SL:QUERYFIELD 下一句]是什么？]
7月13号广州恒大俱乐部的比赛有哪些	[IN:QUERY [SL:DATETIME_DATE 7月13号][SL:NAME 广州恒大]俱乐部的比赛有哪些]
死肉怎么烧好吃？	[IN:QUERY 死[SL:INGREDIENT 肉]怎么烧好吃？]
往火车北站怎么走	[IN:ROUTE 往[SL:ENDLOC_POI 火车北站]怎么走]
打开系统软件清理	[IN:LAUNCH 打开[SL:NAME 系统软件清理]]
杨三姐告状	[IN:QUERY [SL:NAME 杨三姐告状]]
猜谜语，听了。	[IN:QUERY 猜[SL:CATEGORY 谜语]，听了。]
杰瑞股份股价	[IN:QUERY [SL:NAME 杰瑞股份]股价]
嗯，你来一首李白的诗词，的。	[IN:QUERY 嗯，你来一首[SL:AUTHOR 李白]的诗词，的。]
内痔怎么办？	[IN:QUERY [SL:KEYWORD 内痔]怎么办？]
光阴	[IN:QUERY [SL:NAME 光阴]]
查询明天南阳到上海的航班	[IN:QUERY 查询[SL:STARTDATE_DATE 明天][SL:STARTLOC_CITY 南阳]到[SL:ENDLOC_CITY 上海]的航班]
念首诗听一下。	[IN:DEFAULT 念首诗听一下。]
读一首古诗。	[IN:DEFAULT 读一首古诗。]
帮我调转到风云音乐频道	[IN:PLAY 帮我调转到[SL:NAME 风云音乐频道]]
明天去桂林的航班。	[IN:QUERY [SL:STARTDATE_DATE 明天]去[SL:ENDLOC_CITY 桂林]的航班。]
怎么治疗口腔溃疡呃呃呃	[IN:QUERY 怎么治疗[SL:KEYWORD 口腔溃疡]呃呃呃]
发信息给老妈说我在吃饭	[IN:SEND 发信息给[SL:NAME 老妈]说[SL:CONTENT 我在吃饭]]
孙翠鱼怎么做？	[IN:QUERY [SL:INGREDIENT 孙翠鱼]怎么做？]
拔丝芋头怎么做	[IN:QUERY [SL:DISHNAME 拔丝芋头]怎么做]
来一首飞得更高了说完了	[IN:PLAY 来一首[SL:SONG 飞得更高]了说完了]
最美的时光	[IN:QUERY [SL:NAME 最美的时光]]
虾的英文怎么说	[IN:TRANSLATION [SL:CONTENT 虾]的[SL:TARGET 英文]怎么说]
上海能源这支股票怎么样	[IN:QUERY [SL:NAME 上海能源]这支股票怎么样]
晚上好用英语怎么说	[IN:TRANSLATION [SL:CONTENT 晚上好]用[SL:TARGET 英语]怎么说]
徐良唱的歌	[IN:PLAY [SL:ARTIST 徐良]唱的歌]
打开百度哇	[IN:OPEN 打开[SL:NAME 百度]哇]
怎么去龙阳路	[IN:ROUTE 怎么去[SL:ENDLOC_POI 龙阳路]]
不辣，猜谜语。	[IN:QUERY 不辣，猜[SL:CATEGORY 谜语]。]
来一首宝贝对不起	[IN:PLAY 来一首[SL:SONG 宝贝对不起]]
你背首唐诗给我听听啊	[IN:QUERY 你背首[SL:DYNASTY 唐]诗给我听听啊]
我要看灵异推理小说	[IN:QUERY 我要看[SL:CATEGORY 灵异推理]小说]
怎样做糖醋排骨。	[IN:QUERY 怎样做[SL:DISHNAME 糖醋排骨]。]
英雄本色电影	[IN:QUERY [SL:NAME 英雄本色][SL:CATEGORY 电影]]
杭州到郑州飞机票	[IN:QUERY [SL:STARTLOC_CITY 杭州]到[SL:ENDLOC_CITY 郑州]飞机票]
肾虚怎么治疗	[IN:QUERY [SL:KEYWORD 肾虚]怎么治疗]
去华强北的路怎么走	[IN:ROUTE 去[SL:ENDLOC_POI 华强北]的路怎么走]
我要打开百度	[IN:OPEN 我要打开[SL:NAME 百度]]
江山有奇峰，下一句。	[IN:QUERY [SL:KEYWORD 江山有奇峰]，[SL:QUERYFIELD 下一句]。]
读一首唐诗。	[IN:QUERY 读一首[SL:DYNASTY 唐]诗。]
打了怎么做红烧肉的做法？	[IN:QUERY 打了怎么做[SL:DISHNAME 红烧肉]的做法？]
查看王老师的号码	[IN:QUERY 查看[SL:NAME 王老师]的号码]
来一首我们的歌谣。	[IN:PLAY 来一首[SL:SONG 我们的歌谣]。]
豆腐花的做法。	[IN:QUERY [SL:DISHNAME 豆腐花]的做法。]
等，请播报新闻	[IN:PLAY 等，请播报新闻]
风车第十五集	[IN:QUERY [SL:NAME 风车][SL:EPISODE 第十五集]]
说一句，白居易的诗。	[IN:QUERY 说一句，[SL:AUTHOR 白居易]的诗。]
翻译秋天	[IN:TRANSLATION 翻译[SL:CONTENT 秋天]]
爱情片	[IN:QUERY [SL:TAG 爱情][SL:CATEGORY 片]]
哥猜个谜语。	[IN:QUERY 哥猜个[SL:CATEGORY 谜语]。]
给小鱼打电话	[IN:DIAL 给[SL:NAME 小鱼]打电话]
智取威虎山	[IN:QUERY [SL:NAME 智取威虎山]]
我想要看很火的电影	[IN:QUERY 我想要看很[SL:POPULARITY 火]的[SL:CATEGORY 电影]]
查一下杭州到鹰潭的火车票	[IN:QUERY 查一下[SL:STARTLOC_CITY 杭州]到[SL:ENDLOC_CITY 鹰潭]的火车票]
九阴真经	[IN:QUERY [SL:NAME 九阴真经]]
我不吃英文怎么讲	[IN:TRANSLATION [SL:CONTENT 我不吃][SL:TARGET 英文]怎么讲]
t我要听新闻。	[IN:PLAY t我要听新闻。]
永高股份的股票	[IN:QUERY [SL:NAME 永高股份]的股票]
辛夷坞原来你还在这里小说	[IN:QUERY [SL:AUTHOR 辛夷坞][SL:NAME 原来你还在这里]小说]
把小新的号码发给徐云蔚	[IN:SENDCONTACTS 把[SL:NAME 小新]的号码发给[SL:RECEIVER 徐云蔚]]
快乐大本营什么时间播？	[IN:QUERY [SL:NAME 快乐大本营]什么时间播？]
去深圳怎么坐车？	[IN:ROUTE 去[SL:ENDLOC_CITY 深圳]怎么坐车？]
做红酒怎么做啊？	[IN:QUERY 做[SL:INGREDIENT 红酒]怎么做啊？]
哪个电视台在演叶问。	[IN:QUERY 哪个电视台在演[SL:NAME 叶问]。]
山寨鱼怎么做？	[IN:QUERY [SL:DISHNAME 山寨鱼]怎么做？]
床前明月光下一句是怎么说	[IN:QUERY [SL:KEYWORD 床前明月光][SL:QUERYFIELD 下一句]是怎么说]
打开五五两性网站	[IN:OPEN 打开[SL:NAME 五五两性网站]]
我要看现代重生小说	[IN:QUERY 我要看[SL:CATEGORY 现代重生]小说]
北京国安5月23号比赛和谁踢	[IN:QUERY [SL:NAME 北京国安][SL:DATETIME_DATE 5月23号]比赛和谁踢]
你不来一首涛声依旧，那你。	[IN:PLAY 你不来一首[SL:SONG 涛声依旧]，那你。]
我想看喜羊羊	[IN:QUERY 我想看[SL:NAME 喜羊羊]]
中国最强音	[IN:QUERY [SL:NAME 中国最强音]]
周六晚上重庆卫视有转播神探高伦布吗	[IN:QUERY [SL:DATETIME_DATE 周六][SL:DATETIME_TIME 晚上][SL:TVCHANNEL 重庆卫视]有转播[SL:NAME 神探高伦布]吗]
熊出没是几点开始播放。	[IN:QUERY [SL:NAME 熊出没]是几点开始播放。]
从科大讯飞到天鹅湖怎么走能不走高速	[IN:ROUTE 从[SL:STARTLOC_POI 科大讯飞]到[SL:ENDLOC_POI 天鹅湖]怎么走能不走高速]
怎样做面筋	[IN:QUERY 怎样做[SL:INGREDIENT 面筋]]
给园园发短信	[IN:SEND 给[SL:NAME 园园]发短信]
葱烧海参怎么做	[IN:QUERY [SL:DISHNAME 葱烧海参]怎么做]
搜索一下白居易的诗。	[IN:QUERY 搜索一下[SL:AUTHOR 白居易]的诗。]
来个字谜吗？	[IN:QUERY 来个[SL:CATEGORY 字谜]吗？]
从这里去瑞金路怎么走	[IN:ROUTE 从这里去[SL:ENDLOC_POI 瑞金路]怎么走]
茅屋为秋风所破歌杜甫。	[IN:QUERY [SL:NAME 茅屋为秋风所破歌][SL:AUTHOR 杜甫]。]
查询郑州到上海的航班。	[IN:QUERY 查询[SL:STARTLOC_CITY 郑州]到[SL:ENDLOC_CITY 上海]的航班。]
南京熊猫股票	[IN:QUERY [SL:NAME 南京熊猫]股票]
打电话给陈永聪	[IN:DIAL 打电话给[SL:NAME 陈永聪]]
我要看巴拉小魔仙	[IN:QUERY 我要看[SL:NAME 巴拉小魔仙]]
有道词典	[IN:LAUNCH [SL:NAME 有道词典]]
查寻天龙集团的股票	[IN:QUERY 查寻[SL:NAME 天龙集团]的股票]
我要回复这条邮件	[IN:REPLY 我要回复这条邮件]
本省农村广播	[IN:LAUNCH 本省[SL:CATEGORY 农村]广播]
搜索国外大片	[IN:QUERY 搜索[SL:AREA 国外][SL:CATEGORY 大片]]
炒豆腐。	[IN:QUERY [SL:DISHNAME 炒豆腐]。]
搜索蒙牛的股市行情	[IN:QUERY 搜索[SL:NAME 蒙牛]的股市行情]
意大利面。	[IN:QUERY [SL:DISHNAME 意大利面]。]
过敏性鼻炎怎么治疗	[IN:QUERY [SL:KEYWORD 过敏性鼻炎]怎么治疗]
七月三十一日上海虹桥到北京的航班	[IN:QUERY [SL:STARTDATE_DATE 七月三十一日][SL:STARTLOC_CITY 上海][SL:STARTLOC_POI 虹桥]到[SL:ENDLOC_CITY 北京]的航班]
我要上网打开百度	[IN:OPEN 我要上网打开[SL:NAME 百度]]
电视回看安徽卫视	[IN:LOOK_BACK 电视回看[SL:TVCHANNEL 安徽卫视]]
帮我查一下明天南昌到广州的飞机票	[IN:QUERY 帮我查一下[SL:STARTDATE_DATE 明天][SL:STARTLOC_CITY 南昌]到[SL:ENDLOC_CITY 广州]的飞机票]
请帮我调频89.6武汉交通广播电台	[IN:LAUNCH 请帮我调频[SL:CODE 89.6][SL:NAME 武汉交通广播电台]]
请帮我调频97.5湖南人民广播电台文艺台	[IN:LAUNCH 请帮我调频[SL:CODE 97.5][SL:NAME 湖南人民广播电台文艺台]]
发邮件给灿灿说明早我们一起跑步	[IN:SEND 发邮件给[SL:NAME 灿灿]说[SL:CONTENT 明早我们一起跑步]]
再讲一个谜语吧！	[IN:QUERY 再讲一个[SL:CATEGORY 谜语]吧！]
随便来首刘德华的歌。	[IN:PLAY 随便来首[SL:ARTIST 刘德华]的歌。]
中超的比赛预告。	[IN:QUERY [SL:CATEGORY 中超]的比赛[SL:TYPE 预告]。]
附近电影院。	[IN:QUERY 附近电影院。]
朗读一首李白的诗呗！	[IN:QUERY 朗读一首[SL:AUTHOR 李白]的诗呗！]
淮南电视台综合频道节目。	[IN:QUERY [SL:TVCHANNEL 淮南电视台综合频道]节目。]
查一下从广州到南宁的火车票	[IN:QUERY 查一下从[SL:STARTLOC_CITY 广州]到[SL:ENDLOC_CITY 南宁]的火车票]
听新闻，姨。	[IN:PLAY 听新闻，姨。]
广西新闻网	[IN:OPEN [SL:NAME 广西新闻网]]
那就来个字谜吧！	[IN:QUERY 那就来个[SL:CATEGORY 字谜]吧！]
感冒注意什么？	[IN:QUERY [SL:KEYWORD 感冒]注意什么？]
打开浦口生活资讯频道	[IN:PLAY 打开[SL:NAME 浦口生活资讯]频道]
打开科大讯飞网站	[IN:OPEN 打开[SL:NAME 科大讯飞]网站]
最新的新闻播报一下	[IN:PLAY [SL:KEYWORD 最新]的新闻播报一下]
古墓丽影	[IN:QUERY [SL:NAME 古墓丽影]]
打开我的网易	[IN:OPEN 打开我的[SL:NAME 网易]]
甲亢怎么治疗？	[IN:QUERY [SL:KEYWORD 甲亢]怎么治疗？]
查一下济南到潍坊昌乐的火车	[IN:QUERY 查一下[SL:STARTLOC_CITY 济南]到[SL:ENDLOC_CITY 潍坊][SL:ENDLOC_AREA 昌乐]的火车]
我想知道科大讯飞的市值	[IN:QUERY 我想知道[SL:NAME 科大讯飞]的市值]
给靖哥哥发短信说我不回来吃饭了	[IN:SEND 给[SL:NAME 靖哥哥]发短信说[SL:CONTENT 我不回来吃饭了]]
帮我切换到湖南卫视	[IN:PLAY 帮我切换到[SL:NAME 湖南卫视]]
BTV生活节目选择回放	[IN:LOOK_BACK [SL:TVCHANNEL BTV生活]节目选择回放]
看网易财经	[IN:OPEN 看[SL:NAME 网易财经]]
脊髓损伤。	[IN:QUERY [SL:KEYWORD 脊髓损伤]。]
请打开人人网	[IN:OPEN 请打开[SL:NAME 人人网]]
给丹丹发信息我一会儿就回来别等我了	[IN:SEND 给[SL:NAME 丹丹]发信息[SL:CONTENT 我一会儿就回来别等我了]]
蒸鸡蛋糕	[IN:QUERY [SL:DISHNAME 蒸鸡蛋糕]]
高尔夫网球	[IN:PLAY [SL:NAME 高尔夫网球]]
给我找到今天的新闻。	[IN:PLAY 给我找到[SL:DATETIME_DATE 今天]的新闻。]
给梁辉坚发短信	[IN:SEND 给[SL:NAME 梁辉坚]发短信]
发信息给盛吉	[IN:SEND 发信息给[SL:NAME 盛吉]]
搜索，西米露的做法。	[IN:QUERY 搜索，[SL:DISHNAME 西米露]的做法。]
鲤鱼怎么做？	[IN:QUERY [SL:INGREDIENT 鲤鱼]怎么做？]
沿途有没有加油站	[IN:POSITION 沿途有没有[SL:LOCATION_POI 加油站]]
现在有什么热点新闻？	[IN:PLAY [SL:DATETIME_TIME 现在]有什么[SL:CATEGORY 热点]新闻？]
我不知道的英文怎么说	[IN:TRANSLATION [SL:CONTENT 我不知道]的[SL:TARGET 英文]怎么说]
哦我想看中央一台	[IN:PLAY 哦我想看[SL:NAME 中央一台]]
仓央嘉措的诗词。	[IN:QUERY [SL:AUTHOR 仓央嘉措]的诗词。]
女子特警队之火凤凰	[IN:QUERY [SL:NAME 女子特警队之火凤凰]]
今天的新闻有什么？	[IN:PLAY [SL:DATETIME_DATE 今天]的新闻有什么？]
能不能帮我接听中广流行网	[IN:LAUNCH 能不能帮我接听[SL:NAME 中广流行网]]
甲亢。	[IN:QUERY [SL:KEYWORD 甲亢]。]
打电话给张帕楼	[IN:DIAL 打电话给[SL:NAME 张帕楼]]
灯谜惑下。	[IN:QUERY [SL:CATEGORY 灯谜]惑下。]
酸菜鱼怎么烧的？	[IN:QUERY [SL:DISHNAME 酸菜鱼]怎么烧的？]
查询科大讯飞的股价	[IN:QUERY 查询[SL:NAME 科大讯飞]的股价]
黄豆猪蹄汤。	[IN:QUERY [SL:DISHNAME 黄豆猪蹄汤]。]
啊，猜个谜语给我听。	[IN:QUERY 啊，猜个[SL:CATEGORY 谜语]给我听。]
命运派对	[IN:QUERY [SL:NAME 命运派对]]
去金湖县城	[IN:ROUTE 去[SL:ENDLOC_POI 金湖县城]]
2012年美国公告牌音乐大奖颁奖礼	[IN:QUERY [SL:DATETIME_DATE 2012年][SL:NAME 美国公告牌音乐大奖颁奖礼]]
洛阳至西安的火车	[IN:QUERY [SL:STARTLOC_CITY 洛阳]至[SL:ENDLOC_CITY 西安]的火车]
炸里鸡的做法。	[IN:QUERY [SL:DISHNAME 炸里鸡]的做法。]
搜索最新新闻。	[IN:PLAY 搜索最新新闻。]
土豆怎么做才好吃？	[IN:QUERY [SL:INGREDIENT 土豆]怎么做才好吃？]
安徽卫视今天晚上放什么？	[IN:QUERY [SL:TVCHANNEL 安徽卫视][SL:DATETIME_DATE 今天][SL:DATETIME_TIME 晚上]放什么？]
从南京到亳州怎么走	[IN:ROUTE 从[SL:STARTLOC_CITY 南京]到[SL:ENDLOC_CITY 亳州]怎么走]
查询厦门到武夷山的航班	[IN:QUERY 查询[SL:STARTLOC_CITY 厦门]到[SL:ENDLOC_AREA 武夷山]的航班]
今日头条新闻。	[IN:PLAY [SL:MEDIA 今日头条]新闻。]
请查询天津市到哈尔滨的车。	[IN:QUERY 请查询[SL:SRC 天津市]到[SL:DEST 哈尔滨]的车。]
大家今天心情如何用英语怎么说	[IN:TRANSLATION [SL:CONTENT 大家今天心情如何]用[SL:TARGET 英语]怎么说]
查寻三星股价	[IN:QUERY 查寻[SL:NAME 三星]股价]
背一首，纳兰容若的词。	[IN:QUERY 背一首，[SL:AUTHOR 纳兰容若]的词。]
呼叫小惠	[IN:DIAL 呼叫[SL:NAME 小惠]]
下载飞信	[IN:DOWNLOAD 下载[SL:NAME 飞信]]
开启邮件	[IN:LAUNCH 开启邮件]
给黄杠发短信	[IN:SEND 给[SL:NAME 黄杠]发短信]
国际象棋开局	[IN:LAUNCH [SL:NAME 国际象棋]开局]
帮我查一查今天的新闻。	[IN:PLAY 帮我查一查[SL:DATETIME_DATE 今天]的新闻。]
介绍一下尖锐湿疣	[IN:QUERY 介绍一下[SL:KEYWORD 尖锐湿疣]]
你不会念唐诗吗？	[IN:QUERY 你不会念[SL:DYNASTY 唐]诗吗？]
中国共产主义的英文怎么说	[IN:TRANSLATION [SL:CONTENT 中国共产主义]的[SL:TARGET 英文]怎么说]
查找通讯录	[IN:QUERY 查找[SL:NAME 通讯录]]
高清中央8	[IN:PLAY [SL:RESOLUTION 高清][SL:NAME 中央8]]
我要看古言小说	[IN:QUERY 我要看[SL:CATEGORY 古言]小说]
腊鱼。	[IN:QUERY [SL:DISHNAME 腊鱼]。]
平阳怎么走吗	[IN:ROUTE [SL:ENDLOC_AREA 平阳]怎么走吗]
天才碰麻瓜	[IN:QUERY [SL:NAME 天才碰麻瓜]]
帮我找出红烧肉的做法。	[IN:QUERY 帮我找出[SL:DISHNAME 红烧肉]的做法。]
我想听11年，这首歌哦。	[IN:PLAY 我想听[SL:SONG 11年]，这首歌哦。]
脑瘫	[IN:QUERY [SL:KEYWORD 脑瘫]]
帮我调频92.4中国国际广播电台行不行？	[IN:LAUNCH 帮我调频[SL:CODE 92.4][SL:NAME 中国国际广播电台]行不行？]
怎么做煎饼？	[IN:QUERY 怎么做[SL:DISHNAME 煎饼]？]
发短信给王二白叫她明天过来玩	[IN:SEND 发短信给[SL:NAME 王二白]叫她[SL:CONTENT 明天过来玩]]
听江苏交通广播网	[IN:LAUNCH 听[SL:NAME 江苏交通广播]网]
上美空网	[IN:OPEN 上[SL:NAME 美空网]]
到了有鲈鱼怎么做？	[IN:QUERY 到了有[SL:INGREDIENT 鲈鱼]怎么做？]
昨天的北京新闻	[IN:PLAY [SL:DATETIME_DATE 昨天]的[SL:LOCATION_CITY 北京]新闻]
七星彩	[IN:NUMBER_QUERY [SL:NAME 七星彩]]
我想听昨天晚上的新闻。	[IN:PLAY 我想听[SL:DATETIME_DATE 昨天][SL:DATETIME_TIME 晚上]的新闻。]
可以帮我收听安庆新闻综合广播	[IN:LAUNCH 可以帮我收听[SL:NAME 安庆新闻综合广播]]
月咏牡丹的下一句，是什么？	[IN:QUERY [SL:KEYWORD 月咏牡丹]的[SL:QUERYFIELD 下一句]，是什么？]
打电话给子明	[IN:DIAL 打电话给[SL:NAME 子明]]
好看足球比赛	[IN:QUERY [SL:SCOREDESCR 好看][SL:TAG 足球比赛]]
打电话给阿敏	[IN:DIAL 打电话给[SL:NAME 阿敏]]
烧排骨汤需要什么调料？	[IN:QUERY [SL:DISHNAME 烧排骨汤]需要什么调料？]
我想看现在很流行的小说	[IN:QUERY 我想看现在很[SL:POPULARITY 流行]的小说]
炖鸡	[IN:QUERY [SL:DISHNAME 炖鸡]]
打电话给三路店	[IN:DIAL 打电话给[SL:NAME 三路店]]
那好，那你告诉我西红柿炒鸡蛋，怎么去做？	[IN:QUERY 那好，那你告诉我[SL:DISHNAME 西红柿炒鸡蛋]，怎么去做？]
CCTV6电影	[IN:PLAY [SL:NAME CCTV6电影]]
给陈易云发短消息	[IN:SEND 给[SL:NAME 陈易云]发短消息]
来一句唐诗呗！	[IN:QUERY 来一句[SL:DYNASTY 唐]诗呗！]
查询4月1号从武汉到广州的航班	[IN:QUERY 查询[SL:STARTDATE_DATE 4月1号]从[SL:STARTLOC_CITY 武汉]到[SL:ENDLOC_CITY 广州]的航班]
电影钢铁侠并论。	[IN:QUERY 电影[SL:FILM 钢铁侠]并论。]
截瘫吧	[IN:QUERY [SL:KEYWORD 截瘫]吧]
给木九超打电话	[IN:DIAL 给[SL:NAME 木九超]打电话]
鱼香肉丝，怎么做？不？	[IN:QUERY [SL:DISHNAME 鱼香肉丝]，怎么做？不？]
湖南卫视节目录	[IN:QUERY [SL:TVCHANNEL 湖南卫视]节目录]
出租车的英文怎么说	[IN:TRANSLATION [SL:CONTENT 出租车]的[SL:TARGET 英文]怎么说]
多囊肾怎么治啊？	[IN:QUERY [SL:KEYWORD 多囊肾]怎么治啊？]
回看安徽卫视烽火佳人	[IN:LOOK_BACK 回看[SL:TVCHANNEL 安徽卫视][SL:NAME 烽火佳人]]
四川新闻网	[IN:OPEN [SL:NAME 四川新闻网]]
从二手车市场到八一广场怎么走	[IN:ROUTE 从[SL:STARTLOC_POI 二手车市场]到[SL:ENDLOC_POI 八一广场]怎么走]
帮我写一封邮件	[IN:CREATE 帮我写一封邮件]
讯飞语音我想知道山东省东营市今天的新闻。	[IN:PLAY 讯飞语音我想知道[SL:LOCATION_PROVINCE 山东省][SL:LOCATION_CITY 东营市][SL:DATETIME_DATE 今天]的新闻。]
翻译我想去远方	[IN:TRANSLATION 翻译[SL:CONTENT 我想去远方]]
请打开qq	[IN:LAUNCH 请打开[SL:NAME qq]]
胜者即是正义	[IN:QUERY [SL:NAME 胜者即是正义]]
狗光鱼怎么做？	[IN:QUERY 狗光[SL:INGREDIENT 鱼]怎么做？]
广州至南宁航班。	[IN:QUERY [SL:STARTLOC_CITY 广州]至[SL:ENDLOC_CITY 南宁]航班。]
给万结打电话	[IN:DIAL 给[SL:NAME 万结]打电话]
请问酸辣土豆丝是怎么炒的	[IN:QUERY 请问[SL:DISHNAME 酸辣土豆丝]是怎么炒的]
把张新涛电话发给常胜宾	[IN:SENDCONTACTS 把[SL:NAME 张新涛]电话发给[SL:RECEIVER 常胜宾]]
肠易激综合征。	[IN:QUERY [SL:KEYWORD 肠易激综合征]。]
回放昨晚的焦点访谈	[IN:LOOK_BACK 回放[SL:DATETIME_TIME 昨晚]的[SL:NAME 焦点访谈]]
请帮我查找一下奥特曼大电影	[IN:QUERY 请帮我查找一下[SL:NAME 奥特曼大电影]]
新水浒传	[IN:QUERY [SL:NAME 新水浒传]]
嗯，知道红烧肉怎么做？	[IN:QUERY 嗯，知道[SL:DISHNAME 红烧肉]怎么做？]
杜甫的诗。	[IN:QUERY [SL:AUTHOR 杜甫]的诗。]
那你查一下最近的热门电影是什么？	[IN:QUERY 那你查一下[SL:TIMEDESCR 最近]的[SL:POPULARITY 热门][SL:CATEGORY 电影]是什么？]
海南旅游卫视	[IN:PLAY 海南[SL:NAME 旅游卫视]]
从台州到金华的汽车。	[IN:QUERY 从[SL:SRC 台州]到[SL:DEST 金华]的汽车。]
后天去大连的航班	[IN:QUERY [SL:STARTDATE_DATE 后天]去[SL:ENDLOC_CITY 大连]的航班]
包茎怎么办？	[IN:QUERY [SL:KEYWORD 包茎]怎么办？]
我背一首生查子。	[IN:QUERY 我背一首[SL:NAME 生查子]。]
中国银行股票怎么样	[IN:QUERY [SL:NAME 中国银行]股票怎么样]
我想看董浩配音的动漫	[IN:QUERY 我想看[SL:ARTIST 董浩][SL:ARTISTROLE 配音]的[SL:CATEGORY 动漫]]
唱一首两只蝴蝶。	[IN:PLAY 唱一首[SL:SONG 两只蝴蝶]。]
播放2005年励志动漫	[IN:QUERY 播放[SL:DATETIME_DATE 2005年][SL:TAG 励志][SL:CATEGORY 动漫]]
今天有雨吗	[IN:QUERY [SL:DATETIME_DATE 今天][SL:QUESTIONWORD 有][SL:SUBFOCUS 雨]吗]
给原波发短信	[IN:SEND 给[SL:NAME 原波]发短信]
查询重庆水务股票	[IN:QUERY 查询[SL:NAME 重庆水务]股票]
浙江卫视今晚有中国好声音吗？	[IN:QUERY [SL:TVCHANNEL 浙江卫视][SL:DATETIME_TIME 今晚]有[SL:NAME 中国好声音]吗？]
我想听首唐诗。	[IN:QUERY 我想听首[SL:DYNASTY 唐]诗。]
朗读岳飞的满江红。	[IN:QUERY 朗读[SL:AUTHOR 岳飞]的[SL:NAME 满江红]。]
查寻轻舞风股票	[IN:QUERY 查寻[SL:NAME 轻舞风]股票]
牛肉怎么烧	[IN:QUERY [SL:INGREDIENT 牛肉]怎么烧]
打电话给张志国	[IN:DIAL 打电话给[SL:NAME 张志国]]
央视少儿频道的节目的	[IN:QUERY [SL:TVCHANNEL 央视少儿频道]的节目的]
我要看湖南卫视快乐大本营	[IN:QUERY 我要看[SL:TVCHANNEL 湖南卫视][SL:NAME 快乐大本营]]
给我背一首诗。	[IN:DEFAULT 给我背一首诗。]
么，哥来一下最新的新闻。	[IN:PLAY 么，哥来一下最新的新闻。]
淋病怎么治？	[IN:QUERY [SL:KEYWORD 淋病]怎么治？]
下载汉化软件	[IN:DOWNLOAD 下载[SL:NAME 汉化]软件]
给我写一封邮件	[IN:CREATE 给我写一封邮件]
中信证券股票	[IN:QUERY [SL:NAME 中信证券]股票]
搜索最近的，科幻电影。	[IN:QUERY 搜索[SL:TIMEDESCR 最近]的，[SL:TAG 科幻][SL:CATEGORY 电影]。]
从中山到西安的汽车。	[IN:QUERY 从[SL:SRC 中山]到[SL:DEST 西安]的汽车。]
把王建春的电话号码发给张学政	[IN:SENDCONTACTS 把[SL:NAME 王建春]的电话号码发给[SL:RECEIVER 张学政]]
摩尔勇士	[IN:OPEN [SL:NAME 摩尔勇士]]
帮我查一下红烧肉的做法	[IN:QUERY 帮我查一下[SL:DISHNAME 红烧肉]的做法]
北京财经台	[IN:PLAY [SL:NAME 北京财经台]]
打开新闻	[IN:PLAY 打开新闻]
最近有什么影片？	[IN:QUERY 最近有什么影片？]
现在哪个频道播放电视剧	[IN:QUERY [SL:DATETIME_TIME 现在]哪个频道播放[SL:CATEGORY 电视剧]]
猪肉怎么做？	[IN:QUERY [SL:INGREDIENT 猪肉]怎么做？]
我要全部回复	[IN:REPLAY_ALL 我要全部回复]
番红烧肉的做法。	[IN:QUERY 番[SL:DISHNAME 红烧肉]的做法。]
帮我找到微信	[IN:QUERY 帮我找到[SL:NAME 微信]]
湖南卫视娱乐节目。	[IN:QUERY [SL:TVCHANNEL 湖南卫视][SL:CATEGORY 娱乐]节目。]
读一首古诗给我听吧！	[IN:DEFAULT 读一首古诗给我听吧！]
查询一下明天广州到武汉的航班	[IN:QUERY 查询一下[SL:STARTDATE_DATE 明天][SL:STARTLOC_CITY 广州]到[SL:ENDLOC_CITY 武汉]的航班]
打开今天朝记事本软件	[IN:LAUNCH 打开[SL:NAME 今天朝记事本]软件]
你还没有结婚用英语怎么讲	[IN:TRANSLATION [SL:CONTENT 你还没有结婚]用[SL:TARGET 英语]怎么讲]
请帮我调频106.1长沙音乐广播电台	[IN:LAUNCH 请帮我调频[SL:CODE 106.1][SL:NAME 长沙音乐广播电台]]
唐诗哦。	[IN:QUERY [SL:DYNASTY 唐]诗哦。]
所以说李白的诗。	[IN:QUERY 所以说[SL:AUTHOR 李白]的诗。]
手抓饼的做法。	[IN:QUERY [SL:DISHNAME 手抓饼]的做法。]
搜索蜀道难。	[IN:QUERY 搜索[SL:NAME 蜀道难]。]
焦点访谈什么时候播	[IN:QUERY [SL:NAME 焦点访谈]什么时候播]
搜索声控安卓软件	[IN:QUERY 搜索[SL:NAME 声控安卓]软件]
查一下从杭州到上海高铁时刻表	[IN:QUERY 查一下从[SL:STARTLOC_CITY 杭州]到[SL:ENDLOC_CITY 上海][SL:CATEGORY 高铁]时刻表]
海参怎么做？	[IN:QUERY [SL:INGREDIENT 海参]怎么做？]
给刘三发短信说我今天没有空	[IN:SEND 给[SL:NAME 刘三]发短信说[SL:CONTENT 我今天没有空]]
杜甫兵车行。	[IN:QUERY [SL:AUTHOR 杜甫][SL:NAME 兵车行]。]
上百度网站	[IN:OPEN 上[SL:NAME 百度]网站]
最近的新电影有哪些？	[IN:QUERY 最近的新电影有哪些？]
把许琦彪的号码发给徐鹏	[IN:SENDCONTACTS 把[SL:NAME 许琦彪]的号码发给[SL:RECEIVER 徐鹏]]
播放音乐月亮之上的。	[IN:PLAY 播放音乐[SL:SONG 月亮之上]的。]
在菏泽怎么坐去北京的车。	[IN:QUERY 在[SL:SRC 菏泽]怎么坐去[SL:DEST 北京]的车。]
四月六号南宁到上海的火车	[IN:QUERY [SL:STARTDATE_DATE 四月六号][SL:STARTLOC_CITY 南宁]到[SL:ENDLOC_CITY 上海]的火车]
石螺怎么煮	[IN:QUERY [SL:INGREDIENT 石螺]怎么煮]
我记住了用英文怎么讲	[IN:TRANSLATION [SL:CONTENT 我记住了]用[SL:TARGET 英文]怎么讲]
2013年亚洲冠军联赛恒广州恒大比赛时间。	[IN:QUERY [SL:DATETIME_DATE 2013年][SL:CATEGORY 亚洲冠军联赛]恒[SL:NAME 广州恒大]比赛时间。]
保利地产的股票	[IN:QUERY [SL:NAME 保利地产]的股票]
慕斯的做法。	[IN:QUERY [SL:INGREDIENT 慕斯]的做法。]
包钢稀土股票价格	[IN:QUERY [SL:NAME 包钢稀土]股票价格]
搜索手机办公软件	[IN:QUERY 搜索手机[SL:NAME 办公软件]]
把徐程的电话发给吴芳	[IN:SENDCONTACTS 把[SL:NAME 徐程]的电话发给[SL:RECEIVER 吴芳]]
读首唐诗来听听。	[IN:QUERY 读首[SL:DYNASTY 唐]诗来听听。]
火气冲天，下一句是什么？	[IN:QUERY [SL:KEYWORD 火气冲天]，[SL:QUERYFIELD 下一句]是什么？]
搜索第10频道	[IN:PLAY 搜索第[SL:CODE 10]频道]
清蒸鱼怎么做？吴？	[IN:QUERY [SL:DISHNAME 清蒸鱼]怎么做？吴？]
发烧。	[IN:QUERY [SL:KEYWORD 发烧]。]
不，做个红烧肉怎么做？	[IN:QUERY 不，做个[SL:DISHNAME 红烧肉]怎么做？]
高清北京文艺台	[IN:PLAY [SL:RESOLUTION 高清][SL:NAME 北京文艺台]]
到合肥市逍遥津公园怎么走	[IN:ROUTE 到[SL:ENDLOC_CITY 合肥]市[SL:ENDLOC_POI 逍遥津公园]怎么走]
从东莞到厦门的火车票	[IN:QUERY 从[SL:STARTLOC_CITY 东莞]到[SL:ENDLOC_CITY 厦门]的火车票]
周二电影。	[IN:QUERY [SL:DATETIME_DATE 周二]电影。]
播放最近的新闻。	[IN:PLAY 播放[SL:DATETIME_DATE 最近]的新闻。]
蚝油生菜的做法。	[IN:QUERY [SL:DISHNAME 蚝油生菜]的做法。]
猪大肠怎么炒？	[IN:QUERY [SL:INGREDIENT 猪大肠]怎么炒？]
上海到合肥怎么坐汽车？	[IN:QUERY [SL:SRC 上海]到[SL:DEST 合肥]怎么坐汽车？]
给岚岚发短信	[IN:SEND 给[SL:NAME 岚岚]发短信]
帮我找一首我的好兄弟	[IN:SEARCH 帮我找一首我的[SL:SONG 好兄弟]]
科大讯飞在哪里呀	[IN:POSITION [SL:LOCATION_POI 科大讯飞]在哪里呀]
当婆婆遇上妈	[IN:QUERY [SL:NAME 当婆婆遇上妈]]
苏宁易购	[IN:OPEN [SL:NAME 苏宁易购]]
打开4399小游戏	[IN:OPEN 打开[SL:NAME 4399小游戏]]
明天去成都的航班有几趟	[IN:QUERY [SL:STARTDATE_DATE 明天]去[SL:ENDLOC_CITY 成都]的航班有几趟]
给我找最新的盗梦空间	[IN:QUERY 给我找[SL:TIMEDESCR 最新]的[SL:NAME 盗梦空间]]
你怎么了英文怎么讲	[IN:TRANSLATION [SL:CONTENT 你怎么了][SL:TARGET 英文]怎么讲]
发短信给啊妈说车票买到了	[IN:SEND 发短信给[SL:NAME 啊妈]说[SL:CONTENT 车票买到了]]
呦呦鹿鸣的下一句。	[IN:QUERY [SL:KEYWORD 呦呦鹿鸣]的[SL:QUERYFIELD 下一句]。]
即鱼汤怎么做？	[IN:QUERY 即[SL:DISHNAME 鱼汤]怎么做？]
请帮我播放樱桃	[IN:QUERY 请帮我播放[SL:NAME 樱桃]]
文娱播报	[IN:QUERY [SL:NAME 文娱播报]]
糖醋鲤鱼怎么做啊？你只负责吃，c则c。	[IN:QUERY [SL:DISHNAME 糖醋鲤鱼]怎么做啊？你只负责吃，c则c。]
煲鸡汤呢	[IN:QUERY [SL:DISHNAME 煲鸡汤]呢]
发烧好吗？	[IN:QUERY [SL:KEYWORD 发烧]好吗？]
怎样做肉类？	[IN:QUERY 怎样做[SL:INGREDIENT 肉类]？]
炝拌土豆丝。	[IN:QUERY [SL:DISHNAME 炝拌土豆丝]。]
如何治疗脚臭。	[IN:QUERY 如何治疗[SL:KEYWORD 脚臭]。]
听时间煮雨这首歌	[IN:PLAY 听[SL:SONG 时间煮雨]这首歌]
搜一下CCTV74月15号播出新编辑部的故事呢	[IN:QUERY 搜一下[SL:TVCHANNEL CCTV7][SL:DATETIME_DATE 4月15号]播出[SL:NAME 新编辑部的故事]呢]
我是说我要看一起又看流星雨	[IN:QUERY 我是说我要看[SL:NAME 一起又看流星雨]]
国足最新赛程。	[IN:QUERY [SL:CATEGORY 国足]最新赛程。]
金酱肉丝的做法	[IN:QUERY [SL:DISHNAME 金酱肉丝]的做法]
白居易的诗词。	[IN:QUERY [SL:AUTHOR 白居易]的诗词。]
呼叫广岁	[IN:DIAL 呼叫[SL:NAME 广岁]]
来一首李清照的词	[IN:QUERY 来一首[SL:AUTHOR 李清照]的词]
厦门到上海的机票	[IN:QUERY [SL:STARTLOC_CITY 厦门]到[SL:ENDLOC_CITY 上海]的机票]
今晚红烧肉的做法。	[IN:QUERY 今晚[SL:DISHNAME 红烧肉]的做法。]
姨，最近有什么新闻。	[IN:PLAY 姨，[SL:DATETIME_DATE 最近]有什么新闻。]
我想打你英语怎么说	[IN:TRANSLATION [SL:CONTENT 我想打你][SL:TARGET 英语]怎么说]
帮我上下新浪网	[IN:OPEN 帮我上下[SL:NAME 新浪网]]
我要打电话给洪云刚	[IN:DIAL 我要打电话给[SL:NAME 洪云刚]]
西藏卫视	[IN:PLAY [SL:NAME 西藏卫视]]
给张克达发短信	[IN:SEND 给[SL:NAME 张克达]发短信]
泰州新闻。	[IN:PLAY [SL:LOCATION_CITY 泰州]新闻。]
陈忠实的爱情小说《白鹿原》	[IN:QUERY [SL:AUTHOR 陈忠实]的[SL:CATEGORY 爱情]小说《[SL:NAME 白鹿原]》]
酸辣藕丁的做法。	[IN:QUERY [SL:DISHNAME 酸辣藕丁]的做法。]
打电话给my god	[IN:DIAL 打电话给[SL:NAME my god]]
张，来首白居易的诗。	[IN:QUERY 张，来首[SL:AUTHOR 白居易]的诗。]
好吧，我想知道稻香排骨是怎么做的？	[IN:QUERY 好吧，我想知道[SL:DISHNAME 稻香排骨]是怎么做的？]
查询湛江到广州的火车票	[IN:QUERY 查询[SL:STARTLOC_CITY 湛江]到[SL:ENDLOC_CITY 广州]的火车票]
播放落日批示	[IN:QUERY 播放[SL:NAME 落日]批示]
动物谜语。	[IN:QUERY [SL:CATEGORY 动物谜语]。]
看中央七频道讲武堂节目	[IN:QUERY 看[SL:TVCHANNEL 中央七频道][SL:NAME 讲武堂]节目]
影视频道有什么节目	[IN:QUERY [SL:TVCHANNEL 影视频道]有什么节目]
打开我的浏览器	[IN:LAUNCH 打开我的[SL:NAME 浏览器]]
上饶到南昌的火车票	[IN:QUERY [SL:STARTLOC_CITY 上饶]到[SL:ENDLOC_CITY 南昌]的火车票]
那来个灯谜吧！	[IN:QUERY 那来个[SL:CATEGORY 灯谜]吧！]
查一下明天青岛飞往上海的飞机都有哪一些都是几点的	[IN:QUERY 查一下[SL:STARTDATE_DATE 明天][SL:STARTLOC_CITY 青岛]飞往[SL:ENDLOC_CITY 上海]的飞机都有哪一些都是几点的]
潘靖的电话是多少	[IN:QUERY [SL:NAME 潘靖]的电话是多少]
何以解忧的下一句是什么？	[IN:QUERY [SL:KEYWORD 何以解忧]的[SL:QUERYFIELD 下一句]是什么？]
从合肥到北京的列车	[IN:QUERY 从[SL:STARTLOC_CITY 合肥]到[SL:ENDLOC_CITY 北京]的列车]
本期七星彩的中奖号码是多少？	[IN:NUMBER_QUERY 本期[SL:NAME 七星彩]的中奖号码是多少？]
赵包子怎么做的，你？	[IN:QUERY 赵[SL:DISHNAME 包子]怎么做的，你？]
啊，社会新闻。	[IN:PLAY 啊，[SL:CATEGORY 社会]新闻。]
怎么做京酱肉丝。	[IN:QUERY 怎么做[SL:DISHNAME 京酱肉丝]。]
玉照公园怎么走	[IN:ROUTE [SL:ENDLOC_POI 玉照公园]怎么走]
给刘俊发短信	[IN:SEND 给[SL:NAME 刘俊]发短信]
明天安徽卫视演什么	[IN:QUERY [SL:DATETIME_DATE 明天][SL:TVCHANNEL 安徽卫视]演什么]
封神榜	[IN:QUERY [SL:NAME 封神榜]]
你如何做螃蟹？	[IN:QUERY 你如何做[SL:INGREDIENT 螃蟹]？]
江苏影视台	[IN:PLAY [SL:NAME 江苏影视台]]
打电话给hello word	[IN:DIAL 打电话给[SL:NAME hello word]]
查一下从南京到上海的航班	[IN:QUERY 查一下从[SL:STARTLOC_CITY 南京]到[SL:ENDLOC_CITY 上海]的航班]
把千哥的电话号码发给萌萌	[IN:SENDCONTACTS 把[SL:NAME 千哥]的电话号码发给[SL:RECEIVER 萌萌]]
小杰炖蘑菇怎么做？	[IN:QUERY 小杰[SL:DISHNAME 炖蘑菇]怎么做？]
我想全部回应	[IN:REPLAY_ALL 我想全部回应]
请查询一下深圳飞往上海的航班	[IN:QUERY 请查询一下[SL:STARTLOC_CITY 深圳]飞往[SL:ENDLOC_CITY 上海]的航班]
搜索25选5的获奖号码	[IN:NUMBER_QUERY 搜索[SL:NAME 25选5]的获奖号码]
拌面该怎么做？	[IN:QUERY [SL:DISHNAME 拌面]该怎么做？]
肩关节周围炎	[IN:QUERY [SL:KEYWORD 肩关节周围炎]]
新疆大盘鸡的做法。	[IN:QUERY [SL:DISHNAME 新疆大盘鸡]的做法。]
啤酒鸭怎么做？	[IN:QUERY [SL:DISHNAME 啤酒鸭]怎么做？]
从北海到东莞的汽车。	[IN:QUERY 从[SL:SRC 北海]到[SL:DEST 东莞]的汽车。]
背首宋词。	[IN:QUERY 背首[SL:DYNASTY 宋]词。]
鸡煲啊！	[IN:QUERY [SL:DISHNAME 鸡煲]啊！]
查一下兰州到成都的火车票	[IN:QUERY 查一下[SL:STARTLOC_CITY 兰州]到[SL:ENDLOC_CITY 成都]的火车票]
打开谷歌wap	[IN:OPEN 打开[SL:NAME 谷歌]wap]
豆沙包。	[IN:QUERY [SL:DISHNAME 豆沙包]。]
糖醋排骨怎么做呢	[IN:QUERY [SL:DISHNAME 糖醋排骨]怎么做呢]
大西南剿匪记	[IN:QUERY [SL:NAME 大西南剿匪记]]
南山医院到北大医院路线	[IN:ROUTE [SL:STARTLOC_POI 南山医院]到[SL:ENDLOC_POI 北大医院]路线]
访问京东商城的网页	[IN:OPEN 访问[SL:NAME 京东]商城的网页]
呼叫徐媛	[IN:DIAL 呼叫[SL:NAME 徐媛]]
我想听搜狐新闻	[IN:PLAY 我想听[SL:MEDIA 搜狐]新闻]
但是我想上腾讯网	[IN:OPEN 但是我想上[SL:NAME 腾讯网]]
中国新声代	[IN:QUERY [SL:NAME 中国新声代]]
给我讲一个长篇小说。	[IN:QUERY 给我讲一个长篇小说。]
请帮我调频90.2连云港经济广播电台	[IN:LAUNCH 请帮我调频[SL:CODE 90.2][SL:NAME 连云港经济广播电台]]
明天从桂林到杭州的航班	[IN:QUERY [SL:STARTDATE_DATE 明天]从[SL:STARTLOC_CITY 桂林]到[SL:ENDLOC_CITY 杭州]的航班]
美菱电器的昨日收盘价是多少	[IN:CLOSEPRICE_QUERY [SL:NAME 美菱电器]的[SL:YESTERDAY 昨日]收盘价是多少]
虎林市电影院正在上映的大片	[IN:QUERY [SL:THEATRE 虎林市电影院]正在上映的大片]
怎么做冰激凌？	[IN:QUERY 怎么做[SL:DISHNAME 冰激凌]？]
查一下吉安至武汉的火车	[IN:QUERY 查一下[SL:STARTLOC_CITY 吉安]至[SL:ENDLOC_CITY 武汉]的火车]
打开sky电话	[IN:LAUNCH 打开[SL:NAME sky电话]]
我想听期待这首歌	[IN:PLAY 我想听[SL:SONG 期待]这首歌]
打开极品飞车	[IN:LAUNCH 打开[SL:NAME 极品飞车]]
连云港到徐州的火车票	[IN:QUERY [SL:STARTLOC_CITY 连云港]到[SL:ENDLOC_CITY 徐州]的火车票]
后天上海到烟台的火车	[IN:QUERY [SL:STARTDATE_DATE 后天][SL:STARTLOC_CITY 上海]到[SL:ENDLOC_CITY 烟台]的火车]
打开珠江台	[IN:PLAY 打开[SL:NAME 珠江台]]
狸猫换太子	[IN:QUERY [SL:NAME 狸猫换太子]]
告诉我今天的新闻内容	[IN:PLAY 告诉我[SL:DATETIME_DATE 今天]的新闻内容]
你叫什么名字翻译一下	[IN:TRANSLATION [SL:CONTENT 你叫什么名字]翻译一下]
给我来一首山歌吗？	[IN:QUERY 给我来一首[SL:NAME 山歌]吗？]
随便唱几首歌吧	[IN:PLAY 随便唱几首歌吧]
从无锡市到西安市的汽车。	[IN:QUERY 从[SL:SRC 无锡市]到[SL:DEST 西安市]的汽车。]
江苏影视	[IN:PLAY [SL:NAME 江苏影视]]
跳换到湖南卫视	[IN:PLAY 跳换到[SL:NAME 湖南卫视]]
查寻合肥到北京的航班	[IN:QUERY 查寻[SL:STARTLOC_CITY 合肥]到[SL:ENDLOC_CITY 北京]的航班]
从广州到南昌的火车票时刻表	[IN:QUERY 从[SL:STARTLOC_CITY 广州]到[SL:ENDLOC_CITY 南昌]的火车票时刻表]
咱们结婚吧什么时候播出	[IN:DATE_QUERY [SL:NAME 咱们结婚吧]什么时候播出]
找找非诚勿扰什么时候结束	[IN:QUERY 找找[SL:NAME 非诚勿扰]什么时候结束]
陈周的电话号码是多少	[IN:QUERY [SL:NAME 陈周]的电话号码是多少]
影视流星花园	[IN:QUERY [SL:CATEGORY 影视][SL:NAME 流星花园]]
看中国好声音	[IN:QUERY 看[SL:NAME 中国好声音]]
酸菜鱼怎样做	[IN:QUERY [SL:DISHNAME 酸菜鱼]怎样做]
现在哪个台在播放剧情电视剧	[IN:QUERY [SL:DATETIME_TIME 现在]哪个台在播放[SL:CATEGORY 剧情电视剧]]
美好的时代	[IN:QUERY [SL:NAME 美好的时代]]
看一下今天有什么新闻？	[IN:PLAY 看一下[SL:DATETIME_DATE 今天]有什么新闻？]
后天去南京的火车	[IN:QUERY [SL:STARTDATE_DATE 后天]去[SL:ENDLOC_CITY 南京]的火车]
a排骨怎么做好吃？	[IN:QUERY a[SL:INGREDIENT 排骨]怎么做好吃？]
。咳嗽	[IN:QUERY 。[SL:KEYWORD 咳嗽]]
讲点新闻	[IN:PLAY 讲点新闻]
我要订一张到宁波的动车票	[IN:QUERY 我要订一张到[SL:ENDLOC_CITY 宁波]的[SL:CATEGORY 动车]票]
播放上海滩。	[IN:PLAY 播放[SL:SONG 上海滩]。]
火腿肠怎么炒好吃	[IN:QUERY [SL:INGREDIENT 火腿肠]怎么炒好吃]
给姐姐发短信我今天晚上晚点回去你就别等我吃饭	[IN:SEND 给[SL:NAME 姐姐]发短信[SL:CONTENT 我今天晚上晚点回去你就别等我吃饭]]
打电话给之山	[IN:DIAL 打电话给[SL:NAME 之山]]
帮我调到安徽卫视	[IN:PLAY 帮我调到[SL:NAME 安徽卫视]]
魔神战记	[IN:LAUNCH [SL:NAME 魔神战记]]
中超比赛时间多少啊？	[IN:QUERY [SL:CATEGORY 中超]比赛时间多少啊？]
背屈原的离骚	[IN:QUERY 背[SL:AUTHOR 屈原]的[SL:NAME 离骚]]
给我打开百度网	[IN:OPEN 给我打开[SL:NAME 百度]网]
卡酷少儿频道	[IN:PLAY [SL:NAME 卡酷少儿频道]]
帮我转发邮件	[IN:FORWARD 帮我转发邮件]
北疆战士	[IN:QUERY [SL:NAME 北疆战士]]
九月二十六号从深圳到宁波的航班	[IN:QUERY [SL:STARTDATE_DATE 九月二十六号]从[SL:STARTLOC_CITY 深圳]到[SL:ENDLOC_CITY 宁波]的航班]
康熙大帝	[IN:QUERY [SL:NAME 康熙大帝]]
锁梦楼	[IN:QUERY [SL:NAME 锁梦楼]]
我想听音乐忘情水。	[IN:PLAY 我想听音乐[SL:SONG 忘情水]。]
切换浦口新闻综合频道	[IN:PLAY 切换[SL:NAME 浦口新闻综合频道]]
用菜籽油做面包	[IN:QUERY 用[SL:INGREDIENT 菜籽油]做[SL:DISHNAME 面包]]
捍卫者	[IN:QUERY [SL:NAME 捍卫者]]
替我答复这条邮件	[IN:REPLY 替我答复这条邮件]
离我最近的电影院。	[IN:QUERY 离我最近的电影院。]
我们一起去玩吧用英文怎么说	[IN:TRANSLATION [SL:CONTENT 我们一起去玩吧]用[SL:TARGET 英文]怎么说]
南瓜饼的做法。	[IN:QUERY [SL:INGREDIENT 南瓜饼]的做法。]
胜女的代价电视剧	[IN:QUERY [SL:NAME 胜女的代价][SL:CATEGORY 电视剧]]
老故事	[IN:QUERY [SL:CATEGORY 老故事]]
查询广州到北京的火车	[IN:QUERY 查询[SL:STARTLOC_CITY 广州]到[SL:ENDLOC_CITY 北京]的火车]
来一首李煜的词。	[IN:QUERY 来一首[SL:AUTHOR 李煜]的词。]
中超赛事预告，从在哪里看呢？	[IN:QUERY [SL:CATEGORY 中超]赛事[SL:TYPE 预告]，从在哪里看呢？]
哪个频道演爸爸去哪儿	[IN:QUERY 哪个频道演[SL:NAME 爸爸去哪儿]]
打开三星首页	[IN:OPEN 打开[SL:NAME 三星]首页]
去汽车东站怎么走	[IN:ROUTE 去[SL:ENDLOC_POI 汽车东站]怎么走]
我所在地理位置	[IN:POSITION 我所在地理位置]
失明了怎么办？	[IN:QUERY [SL:KEYWORD 失明]了怎么办？]
北京到镇江的火车	[IN:QUERY [SL:STARTLOC_CITY 北京]到[SL:ENDLOC_CITY 镇江]的火车]
如何治疗感冒	[IN:QUERY 如何治疗[SL:KEYWORD 感冒]]
念首唐诗吧！	[IN:QUERY 念首[SL:DYNASTY 唐]诗吧！]
从武汉到呼和浩特	[IN:ROUTE 从[SL:STARTLOC_CITY 武汉]到[SL:ENDLOC_CITY 呼和浩特]]
到无锡到北京的火车有几趟了	[IN:QUERY 到[SL:STARTLOC_CITY 无锡]到[SL:ENDLOC_CITY 北京]的火车有几趟了]
发信息给老婆说我不回家吃饭了	[IN:SEND 发信息给[SL:NAME 老婆]说[SL:CONTENT 我不回家吃饭了]]
打开丰顺县政府网	[IN:OPEN 打开[SL:NAME 丰顺县政府网]]
把淘宝网打开	[IN:OPEN 把[SL:NAME 淘宝网]打开]
搜索郑州到南阳的火车票	[IN:QUERY 搜索[SL:STARTLOC_CITY 郑州]到[SL:ENDLOC_CITY 南阳]的火车票]
我想听想唱就唱	[IN:PLAY 我想听[SL:SONG 想唱就唱]]
嘉兴粽子。	[IN:QUERY [SL:DISHNAME 嘉兴粽子]。]
帮我查一下2013年2月8日开奖的15选5中奖号码	[IN:NUMBER_QUERY 帮我查一下[SL:DATETIME_DATE 2013年2月8日]开奖的[SL:NAME 15选5]中奖号码]
梅毒怎么治疗？	[IN:QUERY [SL:KEYWORD 梅毒]怎么治疗？]
天津电视台的国际频道，拜托了哈	[IN:PLAY [SL:NAME 天津电视台]的[SL:CATEGORY 国际]频道，拜托了哈]
肺结核要注意些啥	[IN:QUERY [SL:KEYWORD 肺结核]要注意些啥]
如何炒花生。	[IN:QUERY 如何[SL:DISHNAME 炒花生]。]
我想看电影台北飘雪	[IN:QUERY 我想看[SL:CATEGORY 电影][SL:NAME 台北飘雪]]
内裤用英语怎么说	[IN:TRANSLATION [SL:CONTENT 内裤]用[SL:TARGET 英语]怎么说]
k新闻想听新闻。	[IN:PLAY k新闻想听新闻。]
opera浏览器	[IN:LAUNCH [SL:NAME opera浏览器]]
瞌睡鱼怎么做？	[IN:QUERY 瞌睡[SL:INGREDIENT 鱼]怎么做？]
北京卡酷熊出没	[IN:QUERY [SL:TVCHANNEL 北京卡酷][SL:NAME 熊出没]]
做酸菜鱼。	[IN:QUERY 做[SL:DISHNAME 酸菜鱼]。]
正韵打开相机	[IN:LAUNCH 正韵打开[SL:NAME 相机]]
糯米肉怎么做？	[IN:QUERY [SL:DISHNAME 糯米肉]怎么做？]
猜个谜语哦。	[IN:QUERY 猜个[SL:CATEGORY 谜语]哦。]
你帮我打开网站	[IN:OPEN 你帮我打开网站]
八月十号从重庆到武汉的航班	[IN:QUERY [SL:STARTDATE_DATE 八月十号]从[SL:STARTLOC_CITY 重庆]到[SL:ENDLOC_CITY 武汉]的航班]
4月28号上海到南昌的航班	[IN:QUERY [SL:STARTDATE_DATE 4月28号][SL:STARTLOC_CITY 上海]到[SL:ENDLOC_CITY 南昌]的航班]
回锅肉。	[IN:QUERY [SL:DISHNAME 回锅肉]。]
阿勋中集集团的股票	[IN:QUERY 阿勋[SL:NAME 中集集团]的股票]
小c我想看北京青年	[IN:QUERY 小c我想看[SL:NAME 北京青年]]
我不在家英语怎么说	[IN:TRANSLATION [SL:CONTENT 我不在家][SL:TARGET 英语]怎么说]
查询中超赛事。	[IN:QUERY 查询[SL:CATEGORY 中超]赛事。]
播放田园的歌	[IN:PLAY 播放[SL:ARTIST 田园]的歌]
北京财经	[IN:PLAY [SL:NAME 北京财经]]
我要看末世进化小说	[IN:QUERY 我要看[SL:CATEGORY 末世进化]小说]
咸鸡，的制作方法。	[IN:QUERY [SL:INGREDIENT 咸鸡]，的制作方法。]
怎么做饭好吃？	[IN:QUERY 怎么做[SL:DISHNAME 饭]好吃？]
明天回广州的航班	[IN:QUERY [SL:STARTDATE_DATE 明天]回[SL:ENDLOC_CITY 广州]的航班]
失眠怎么办呀	[IN:QUERY [SL:KEYWORD 失眠]怎么办呀]
来一首听你听我	[IN:PLAY 来一首[SL:SONG 听你听我]]
CCTV农业	[IN:PLAY [SL:NAME CCTV农业]]
把张三的电话发给李四	[IN:SENDCONTACTS 把[SL:NAME 张三]的电话发给[SL:RECEIVER 李四]]
从杭州到黄山的汽车。	[IN:QUERY 从[SL:SRC 杭州]到[SL:DEST 黄山]的汽车。]
发邮件给莹莹说我好困我想睡觉	[IN:SEND 发邮件给[SL:NAME 莹莹]说[SL:CONTENT 我好困我想睡觉]]
打电话给美华	[IN:DIAL 打电话给[SL:NAME 美华]]
有什么好听的歌	[IN:SEARCH 有什么[SL:CATEGORY 好听]的歌]
但我想点新闻。	[IN:PLAY 但我想点新闻。]
煮面怎么做？	[IN:QUERY [SL:DISHNAME 煮面]怎么做？]
列车深圳到广州	[IN:QUERY 列车[SL:STARTLOC_CITY 深圳]到[SL:ENDLOC_CITY 广州]]
得了艾滋病怎么办	[IN:QUERY 得了[SL:KEYWORD 艾滋病]怎么办]
小说英语怎么说	[IN:TRANSLATION [SL:CONTENT 小说][SL:TARGET 英语]怎么说]
最近有什么热门新闻了。	[IN:PLAY [SL:DATETIME_DATE 最近]有什么[SL:CATEGORY 热门]新闻了。]
酱牛肉怎么做	[IN:QUERY [SL:DISHNAME 酱牛肉]怎么做]
给张张打电话	[IN:DIAL 给[SL:NAME 张张]打电话]
凉面。	[IN:QUERY [SL:DISHNAME 凉面]。]
宁波一台	[IN:PLAY [SL:NAME 宁波一台]]
请问红烧茄子怎么做？	[IN:QUERY 请问[SL:DISHNAME 红烧茄子]怎么做？]
科大讯飞的股票是多少a	[IN:QUERY [SL:NAME 科大讯飞]的股票是多少a]
姐你红烧肉怎么做呀	[IN:QUERY 姐你[SL:DISHNAME 红烧肉]怎么做呀]
潍坊到济南的火车票	[IN:QUERY [SL:STARTLOC_CITY 潍坊]到[SL:ENDLOC_CITY 济南]的火车票]
辽宁大连在哪里	[IN:POSITION [SL:LOCATION_PROVINCE 辽宁][SL:LOCATION_CITY 大连]在哪里]
把张玉娟的手机号码发送给吴伟	[IN:SENDCONTACTS 把[SL:NAME 张玉娟]的[SL:CATEGORY 手机]号码发送给[SL:RECEIVER 吴伟]]
电影院有什么电影？	[IN:QUERY 电影院有什么电影？]
那你给我背一首唐诗吧！	[IN:QUERY 那你给我背一首[SL:DYNASTY 唐]诗吧！]
打电话给潘立长	[IN:DIAL 打电话给[SL:NAME 潘立长]]
科大讯飞的股价如何	[IN:QUERY [SL:NAME 科大讯飞]的股价如何]
远教四台	[IN:PLAY [SL:NAME 远教四台]]
你给我背一首白居易的诗。	[IN:QUERY 你给我背一首[SL:AUTHOR 白居易]的诗。]
明天去蚌埠的车票	[IN:QUERY [SL:STARTDATE_DATE 明天]去[SL:ENDLOC_CITY 蚌埠]的车票]
浙江台	[IN:PLAY [SL:NAME 浙江台]]
最近有什么新片子？	[IN:QUERY 最近有什么[SL:TIMEDESCR 新]片子？]
找一下詹姆斯卡梅隆拍的电影	[IN:QUERY 找一下[SL:ARTIST 詹姆斯卡梅隆]拍的[SL:CATEGORY 电影]]
我的爱金枝玉叶	[IN:QUERY [SL:NAME 我的爱金枝玉叶]]
从合肥去西安的火车	[IN:QUERY 从[SL:STARTLOC_CITY 合肥]去[SL:ENDLOC_CITY 西安]的火车]
汽车总动员	[IN:QUERY [SL:NAME 汽车总动员]]
明天有什么活动用英语怎么讲	[IN:TRANSLATION [SL:CONTENT 明天有什么活动]用[SL:TARGET 英语]怎么讲]
帮我写个邮件	[IN:CREATE 帮我写个邮件]
把李会计的电话发给小江	[IN:SENDCONTACTS 把[SL:NAME 李会计]的电话发给[SL:RECEIVER 小江]]
打开昆明三六零手机网	[IN:OPEN 打开[SL:NAME 昆明三六零手机网]]
中国工商银行的股票	[IN:QUERY [SL:NAME 中国工商银行]的股票]
那中央六台明天演什么节目	[IN:QUERY 那[SL:TVCHANNEL 中央六台][SL:DATETIME_DATE 明天]演什么节目]
哦钢结构的电话是多少	[IN:QUERY [SL:NAME 哦钢结构]的电话是多少]
过油肉土豆片怎么做？	[IN:QUERY [SL:DISHNAME 过油肉土豆片]怎么做？]
查下上海到太原的机票	[IN:QUERY 查下[SL:STARTLOC_CITY 上海]到[SL:ENDLOC_CITY 太原]的机票]
报点新闻给我听。	[IN:PLAY 报点新闻给我听。]
查查一下连江到湛江的火车票	[IN:QUERY 查查一下[SL:STARTLOC_AREA 连江]到[SL:ENDLOC_CITY 湛江]的火车票]
看乡村爱情	[IN:QUERY 看[SL:NAME 乡村爱情]]
中央三今天有什么节目	[IN:QUERY [SL:TVCHANNEL 中央三][SL:DATETIME_DATE 今天]有什么节目]
你，湖南卫视正在播出什么？你。	[IN:QUERY 你，[SL:TVCHANNEL 湖南卫视]正在播出什么？你。]
怎样煮酸甜排骨。	[IN:QUERY 怎样煮[SL:DISHNAME 酸甜排骨]。]
去常州武进路线	[IN:ROUTE 去[SL:ENDLOC_CITY 常州][SL:ENDLOC_AREA 武进]路线]
查一下广州到信阳的火车票	[IN:QUERY 查一下[SL:STARTLOC_CITY 广州]到[SL:ENDLOC_CITY 信阳]的火车票]
我想跟今天的新闻。	[IN:PLAY 我想跟[SL:DATETIME_DATE 今天]的新闻。]
查询大大后天广州到武汉的航班	[IN:QUERY 查询[SL:STARTDATE_DATE 大大后天][SL:STARTLOC_CITY 广州]到[SL:ENDLOC_CITY 武汉]的航班]
白灼菜心怎么做？	[IN:QUERY [SL:DISHNAME 白灼菜心]怎么做？]
甲型肝炎。	[IN:QUERY [SL:KEYWORD 甲型肝炎]。]
做黄焖小土豆怎么做啊？	[IN:QUERY 做黄[SL:DISHNAME 焖小土豆]怎么做啊？]
万科a股票	[IN:QUERY [SL:NAME 万科a]股票]
我想到科大讯飞怎么走	[IN:ROUTE 我想到[SL:ENDLOC_POI 科大讯飞]怎么走]
新扎师妹	[IN:QUERY [SL:NAME 新扎师妹]]
太原到广州的车。	[IN:QUERY [SL:SRC 太原]到[SL:DEST 广州]的车。]
查查13年的一站到底	[IN:QUERY 查查[SL:DATETIME_DATE 13年]的[SL:NAME 一站到底]]
怎么烧西红柿炒蛋	[IN:QUERY 怎么烧[SL:DISHNAME 西红柿炒蛋]]
查询恒光电影院即将上映的电影	[IN:QUERY 查询[SL:THEATRE 恒光电影院]即将上映的电影]
小白菜拌豆腐怎么做呀？	[IN:QUERY 小[SL:DISHNAME 白菜拌豆腐]怎么做呀？]
给吴方婷打电话	[IN:DIAL 给[SL:NAME 吴方婷]打电话]
帮我搜索三国杀	[IN:QUERY 帮我搜索[SL:NAME 三国杀]]
再来一首飞得更高。	[IN:PLAY 再来一首[SL:SONG 飞得更高]。]
广州恒大亚冠联赛，比赛时间。	[IN:QUERY [SL:NAME 广州恒大][SL:CATEGORY 亚冠联赛]，比赛时间。]
7月30号去深圳的航班。	[IN:QUERY [SL:STARTDATE_DATE 7月30号]去[SL:ENDLOC_CITY 深圳]的航班。]
我回去看昨天晚上播出的爸爸去哪儿31频道	[IN:QUERY 我回去看[SL:DATETIME_DATE 昨天][SL:DATETIME_TIME 晚上]播出的[SL:NAME 爸爸去哪儿][SL:CODE 31]频道]
能山药怎么做？	[IN:QUERY 能[SL:INGREDIENT 山药]怎么做？]
人福医药股票	[IN:QUERY [SL:NAME 人福医药]股票]
我要看新闻玩不？	[IN:PLAY 我要看新闻玩不？]
幻影忍者	[IN:QUERY [SL:NAME 幻影忍者]]
CCTV8高清电视剧	[IN:QUERY [SL:TVCHANNEL CCTV8高清][SL:CATEGORY 电视剧]]
查一查上影电影院即将上映的影片	[IN:QUERY 查一查上影电影院即将上映的影片]
蛋糕可以做蛋糕吗？	[IN:QUERY [SL:DISHNAME 蛋糕]可以做[SL:DISHNAME 蛋糕]吗？]
恩，红烧土豆怎么做我想学？	[IN:QUERY 恩，[SL:DISHNAME 红烧土豆]怎么做我想学？]
给我放首歌	[IN:PLAY 给我放首歌]
语音火锅怎么做啊？啊？	[IN:QUERY 语音[SL:DISHNAME 火锅]怎么做啊？啊？]
猪肚鸡怎么做啊？	[IN:QUERY [SL:DISHNAME 猪肚鸡]怎么做啊？]
唐诗登高。	[IN:QUERY [SL:DYNASTY 唐]诗[SL:NAME 登高]。]
抬头见喜	[IN:QUERY [SL:NAME 抬头见喜]]
红烧芋头做法。	[IN:QUERY [SL:DISHNAME 红烧芋头]做法。]
查询广州到贵港的火车	[IN:QUERY 查询[SL:STARTLOC_CITY 广州]到[SL:ENDLOC_CITY 贵港]的火车]
糖醋里脊啊，啊	[IN:QUERY [SL:DISHNAME 糖醋里脊]啊，啊]
蓝猫龙骑团	[IN:QUERY [SL:NAME 蓝猫龙骑团]]
龙王庙在哪里	[IN:POSITION [SL:LOCATION_POI 龙王庙]在哪里]
CCTV-12套的节目单	[IN:QUERY [SL:TVCHANNEL CCTV-12]套的节目单]
搜一搜三毛的小说	[IN:QUERY 搜一搜[SL:AUTHOR 三毛]的小说]
帮我查一下赣州到南昌的火车票	[IN:QUERY 帮我查一下[SL:STARTLOC_CITY 赣州]到[SL:ENDLOC_CITY 南昌]的火车票]
晋江到武汉的航班	[IN:QUERY [SL:STARTLOC_AREA 晋江]到[SL:ENDLOC_CITY 武汉]的航班]
看一看大乐透的信息	[IN:NUMBER_QUERY 看一看[SL:NAME 大乐透]的信息]
帮我打开人人	[IN:LAUNCH 帮我打开[SL:NAME 人人]]
地三鲜怎么做？你？	[IN:QUERY [SL:DISHNAME 地三鲜]怎么做？你？]
我要看魔幻学院小说	[IN:QUERY 我要看[SL:CATEGORY 魔幻学院]小说]
给我打个谜语，啊！	[IN:QUERY 给我打个[SL:CATEGORY 谜语]，啊！]
土豆丝是怎么炒？	[IN:QUERY [SL:DISHNAME 土豆丝]是怎么炒？]
小c 你好我想看河北卫视	[IN:PLAY 小c 你好我想看[SL:NAME 河北卫视]]
来点歌听听	[IN:PLAY 来点歌听听]
给曹广义打电话	[IN:DIAL 给[SL:NAME 曹广义]打电话]
来首出师表	[IN:PLAY 来首[SL:SONG 出师表]]
烧伤怎么治疗啊？	[IN:QUERY [SL:KEYWORD 烧伤]怎么治疗啊？]
发短信给叶少云晚上要不要出去玩	[IN:SEND 发短信给[SL:NAME 叶少云][SL:CONTENT 晚上要不要出去玩]]
传简讯给家里	[IN:SEND 传简讯给[SL:NAME 家里]]
搜索15选5的号码信息	[IN:NUMBER_QUERY 搜索[SL:NAME 15选5]的号码信息]
三女休夫	[IN:QUERY [SL:NAME 三女休夫]]
鱼香肉丝哦	[IN:QUERY [SL:DISHNAME 鱼香肉丝]哦]
做糖醋排骨	[IN:QUERY 做[SL:DISHNAME 糖醋排骨]]
你给我讲讲红烧肉的做法。	[IN:QUERY 你给我讲讲[SL:DISHNAME 红烧肉]的做法。]
搜索泰亚股份股票	[IN:QUERY 搜索[SL:NAME 泰亚股份]股票]
我要写条新邮件	[IN:CREATE 我要写条新邮件]
点一首爱情买卖来听听	[IN:PLAY 点一首[SL:SONG 爱情买卖]来听听]
你吃过早饭了吗用英文怎么讲	[IN:TRANSLATION [SL:CONTENT 你吃过早饭了吗]用[SL:TARGET 英文]怎么讲]
放一首其实我介意	[IN:PLAY 放一首[SL:SONG 其实我介意]]
安哥拉的英文是什么	[IN:TRANSLATION [SL:CONTENT 安哥拉]的[SL:TARGET 英文]是什么]
那给我背静夜思。	[IN:QUERY 那给我背[SL:NAME 静夜思]。]
帮我搜索一下宜春到长沙的火车	[IN:QUERY 帮我搜索一下[SL:STARTLOC_CITY 宜春]到[SL:ENDLOC_CITY 长沙]的火车]
盐水鸭怎么做？	[IN:QUERY [SL:DISHNAME 盐水鸭]怎么做？]
甄嬛传高清	[IN:QUERY [SL:NAME 甄嬛传][SL:RESOLUTION 高清]]
开启qq	[IN:LAUNCH 开启[SL:NAME qq]]
我要到徐家汇怎么走	[IN:ROUTE 我要到[SL:ENDLOC_POI 徐家汇]怎么走]
x战警第一部	[IN:QUERY [SL:NAME x战警][SL:SEASON 第一部]]
打开中关村在线网	[IN:OPEN 打开[SL:NAME 中关村在线]网]
查一下到洛阳的高铁	[IN:QUERY 查一下到[SL:ENDLOC_CITY 洛阳]的[SL:CATEGORY 高铁]]
居然股份股票怎么样	[IN:QUERY [SL:NAME 居然股份]股票怎么样]
查找科大讯飞股票的股价	[IN:QUERY 查找[SL:NAME 科大讯飞]股票的股价]
那就来一首李白的诗词。	[IN:QUERY 那就来一首[SL:AUTHOR 李白]的诗词。]
得了皮肤病怎么办？	[IN:QUERY 得了[SL:KEYWORD 皮肤病]怎么办？]
打开骏网一卡通	[IN:OPEN 打开[SL:NAME 骏网一卡通]]
现在中央一台在播什么节目？	[IN:QUERY [SL:DATETIME_TIME 现在][SL:TVCHANNEL 中央一台]在播什么节目？]
红烧排骨怎么做？啊？	[IN:QUERY [SL:DISHNAME 红烧排骨]怎么做？啊？]
西兰花怎么做？	[IN:QUERY [SL:INGREDIENT 西兰花]怎么做？]
牛骨汤	[IN:QUERY [SL:DISHNAME 牛骨汤]]
包皮包茎	[IN:QUERY [SL:KEYWORD 包皮包茎]]
请问牛排怎么做	[IN:QUERY 请问[SL:DISHNAME 牛排]怎么做]
鱼要怎么煮才好吃	[IN:QUERY [SL:INGREDIENT 鱼]要怎么煮才好吃]
不蒸了牛肉丸	[IN:QUERY 不蒸了[SL:DISHNAME 牛肉丸]]
查一下明天晚上17点30分从上海飞往珠海三灶机场的飞机	[IN:QUERY 查一下[SL:STARTDATE_DATE 明天]晚上[SL:STARTDATE_TIME 17点30分]从[SL:STARTLOC_CITY 上海]飞往[SL:ENDLOC_CITY 珠海][SL:ENDLOC_POI 三灶机场]的飞机]
羊肉怎么烧？	[IN:QUERY [SL:INGREDIENT 羊肉]怎么烧？]
好无聊哇有什么好看的电影	[IN:QUERY 好无聊哇有什么[SL:SCOREDESCR 好看]的[SL:CATEGORY 电影]]
我把相机打开	[IN:LAUNCH 我把[SL:NAME 相机]打开]
最新电影	[IN:QUERY [SL:TIMEDESCR 最新][SL:CATEGORY 电影]]
给叶君恩打电话	[IN:DIAL 给[SL:NAME 叶君恩]打电话]
看看今天有什么好看的节目？	[IN:QUERY 看看[SL:DATETIME_DATE 今天]有什么好看的[SL:CATEGORY 节目]？]
怎么做馒头	[IN:QUERY 怎么做[SL:DISHNAME 馒头]]
下个星期中国足球超级联赛淘汰赛的赛事前瞻	[IN:QUERY [SL:DATETIME_DATE 下个星期][SL:CATEGORY 中国足球超级联赛]淘汰赛的赛事前瞻]
来首甘露寺。	[IN:QUERY 来首[SL:NAME 甘露寺]。]
贫血怎么治？	[IN:QUERY [SL:KEYWORD 贫血]怎么治？]
给青发短信	[IN:SEND 给[SL:NAME 青]发短信]
电影频道今天放什么	[IN:QUERY [SL:TVCHANNEL 电影频道][SL:DATETIME_DATE 今天]放什么]
替我回复邮件	[IN:REPLY 替我回复邮件]
帮忙讲几个谜语给我猜。	[IN:QUERY 帮忙讲几个[SL:CATEGORY 谜语]给我猜。]
包皮过长，怎么办？哦。	[IN:QUERY [SL:KEYWORD 包皮过长]，怎么办？哦。]
我要看游戏异界小说	[IN:QUERY 我要看[SL:CATEGORY 游戏异界]小说]
查寻标兵的号码	[IN:QUERY 查[SL:NAME 寻标兵]的号码]
啊，青椒炒蛋。	[IN:QUERY 啊，[SL:DISHNAME 青椒炒蛋]。]
噗我想听新闻。	[IN:PLAY 噗我想听新闻。]
从这里去科大讯飞如何去	[IN:ROUTE 从这里去[SL:ENDLOC_POI 科大讯飞]如何去]
宁波到杭州的汽车	[IN:QUERY [SL:SRC 宁波]到[SL:DEST 杭州]的汽车]
发邮件给晶晶	[IN:SEND 发邮件给[SL:NAME 晶晶]]
汕头到重庆的航班	[IN:QUERY [SL:STARTLOC_CITY 汕头]到[SL:ENDLOC_CITY 重庆]的航班]
那么最近有什么好电影呢？	[IN:QUERY 那么[SL:TIMEDESCR 最近]有什么[SL:SCOREDESCR 好][SL:CATEGORY 电影]呢？]
把王世怀的号码发给乔丽君	[IN:SENDCONTACTS 把[SL:NAME 王世怀]的号码发给[SL:RECEIVER 乔丽君]]
请帮我打开电影	[IN:QUERY 请帮我打开[SL:CATEGORY 电影]]
国防军事频道2天后播捍卫者	[IN:QUERY [SL:TVCHANNEL 国防军事]频道[SL:DATETIME_DATE 2天后]播[SL:NAME 捍卫者]]
浏览一下百度	[IN:OPEN 浏览一下[SL:NAME 百度]]
能帮我收听淄博音乐广播	[IN:LAUNCH 能帮我收听[SL:NAME 淄博音乐广播]]
周慧的电话。	[IN:QUERY [SL:NAME 周慧]的电话。]
央视三台现在播放什么节目	[IN:QUERY [SL:TVCHANNEL 央视三台][SL:DATETIME_TIME 现在]播放什么节目]
你说谜语给我猜。	[IN:QUERY 你说[SL:CATEGORY 谜语]给我猜。]
从厦门到昆明的飞机	[IN:QUERY 从[SL:STARTLOC_CITY 厦门]到[SL:ENDLOC_CITY 昆明]的飞机]
打电话给胖头	[IN:DIAL 打电话给[SL:NAME 胖头]]
红烧鱼块。	[IN:QUERY [SL:DISHNAME 红烧鱼块]。]
糖醋鲤鱼怎么做？而？	[IN:QUERY [SL:DISHNAME 糖醋鲤鱼]怎么做？而？]
你给朴叔打电话	[IN:DIAL 你给[SL:NAME 朴叔]打电话]
同是天涯沦落人下一句。	[IN:QUERY [SL:KEYWORD 同是天涯沦落人][SL:QUERYFIELD 下一句]。]
你会查火车票么	[IN:QUERY 你会查火车票么]
是否还有其他关于钓鱼岛的新闻	[IN:PLAY 是否还有其他关于[SL:KEYWORD 钓鱼岛]的新闻]
半夜不要照镜子	[IN:QUERY [SL:NAME 半夜不要照镜子]]
打电话给何健	[IN:DIAL 打电话给[SL:NAME 何健]]
怎么做？酸菜鱼？	[IN:QUERY 怎么做？[SL:DISHNAME 酸菜鱼]？]
去科大讯飞怎么走	[IN:ROUTE 去[SL:ENDLOC_POI 科大讯飞]怎么走]
五梆瓜鸡蛋汤怎么做？	[IN:QUERY 五梆瓜[SL:DISHNAME 鸡蛋汤]怎么做？]
打开百度啊	[IN:OPEN 打开[SL:NAME 百度]啊]
大肠癌	[IN:QUERY [SL:KEYWORD 大肠癌]]
湖南卫视明天播什么节目	[IN:QUERY [SL:TVCHANNEL 湖南卫视][SL:DATETIME_DATE 明天]播什么节目]
给杨斌发短信	[IN:SEND 给[SL:NAME 杨斌]发短信]
上周六发现之旅有演星跳水立方呢	[IN:QUERY 上周六[SL:TVCHANNEL 发现之旅]有[SL:NAME 演星跳水立方]呢]
中国太保股票	[IN:QUERY [SL:NAME 中国太保]股票]
我要听宋词。	[IN:QUERY 我要听[SL:DYNASTY 宋]词。]
民间小炒肉的做法。	[IN:QUERY 民间[SL:DISHNAME 小炒肉]的做法。]
搜索大乐透的中奖号码	[IN:NUMBER_QUERY 搜索[SL:NAME 大乐透]的中奖号码]
导航到江门	[IN:ROUTE 导航到[SL:ENDLOC_CITY 江门]]
用电压力锅怎么蒸米粉肉。	[IN:QUERY 用电[SL:UTENSIL 压力锅]怎么[SL:DISHNAME 蒸米粉肉]。]
赶紧推荐一部小说。	[IN:QUERY 赶紧推荐一部小说。]
钢铁侠三	[IN:QUERY [SL:NAME 钢铁侠三]]
金枝欲孽	[IN:QUERY [SL:NAME 金枝欲孽]]
呃发信息给周玉豪	[IN:SEND 呃发信息给[SL:NAME 周玉豪]]
查询后天成都到伦敦的航班	[IN:QUERY 查询[SL:STARTDATE_DATE 后天][SL:STARTLOC_CITY 成都]到[SL:ENDLOC_CITY 伦敦]的航班]
故宫鱼怎么做？	[IN:QUERY [SL:INGREDIENT 故宫鱼]怎么做？]
查询一汽轿车股票	[IN:QUERY 查询[SL:NAME 一汽轿车]股票]
游戏竞技频道	[IN:PLAY [SL:NAME 游戏竞技频道]]
出口在哪里英文怎么说	[IN:TRANSLATION [SL:CONTENT 出口在哪里][SL:TARGET 英文]怎么说]
个来一首路灯下的小姑娘。	[IN:PLAY 个来一首[SL:SONG 路灯下的小姑娘]。]
少儿节目中央少儿节目	[IN:QUERY [SL:CATEGORY 少儿]节目中央[SL:CATEGORY 少儿]节目]
给张大萍发短信	[IN:SEND 给[SL:NAME 张大萍]发短信]
伊利股份股票	[IN:QUERY [SL:NAME 伊利股份]股票]
我想看电影超人	[IN:QUERY 我想看[SL:CATEGORY 电影][SL:NAME 超人]]
你会猜谜语吗？	[IN:QUERY 你会猜[SL:CATEGORY 谜语]吗？]
给胡克发短信	[IN:SEND 给[SL:NAME 胡克]发短信]
读一首古诗给我听。	[IN:DEFAULT 读一首古诗给我听。]
女人的颜色六十九集	[IN:QUERY [SL:NAME 女人的颜色][SL:EPISODE 六十九集]]
中超比赛时间，我。	[IN:QUERY [SL:CATEGORY 中超]比赛时间，我。]
给我念首春晓。	[IN:QUERY 给我念首[SL:NAME 春晓]。]
江苏舜天队这个星期的比赛时间给我找出来	[IN:QUERY [SL:NAME 江苏舜天]队[SL:DATETIME_DATE 这个星期]的比赛时间给我找出来]
湖北卫视今天下午六点以后开始播男生女生向前冲	[IN:QUERY [SL:TVCHANNEL 湖北卫视][SL:DATETIME_DATE 今天][SL:DATETIME_TIME 下午六点以后]开始播[SL:NAME 男生女生向前冲]]
我想听春天里这首歌	[IN:PLAY 我想听[SL:SONG 春天里]这首歌]
发短信给贤想快点给我送早饭开门我饿死了	[IN:SEND 发短信给[SL:NAME 贤][SL:CONTENT 想快点给我送早饭开门我饿死了]]
手癣怎么治疗？	[IN:QUERY [SL:KEYWORD 手癣]怎么治疗？]
来一首水调歌头。	[IN:QUERY 来一首[SL:NAME 水调歌头]。]
今天温州有什么新闻。	[IN:PLAY [SL:DATETIME_DATE 今天][SL:LOCATION_CITY 温州]有什么新闻。]
去伦敦的航班	[IN:QUERY 去[SL:ENDLOC_CITY 伦敦]的航班]
我想听莫失莫忘。	[IN:PLAY 我想听[SL:SONG 莫失莫忘]。]
常州在哪	[IN:POSITION [SL:LOCATION_CITY 常州]在哪]
当前不再呼叫英语怎么说	[IN:TRANSLATION [SL:CONTENT 当前不再呼叫][SL:TARGET 英语]怎么说]
高清广东台	[IN:PLAY [SL:RESOLUTION 高清][SL:NAME 广东台]]
我要买电脑的英语怎么说	[IN:TRANSLATION [SL:CONTENT 我要买电脑]的[SL:TARGET 英语]怎么说]
恶熊出没	[IN:QUERY 恶[SL:NAME 熊出没]]
关节痛怎么办？	[IN:QUERY [SL:KEYWORD 关节痛]怎么办？]
搜索小说校园全能高手。	[IN:QUERY 搜索小说[SL:NAME 校园全能高手]。]
能不能看当前的中超联赛	[IN:QUERY 能不能看当前的[SL:NAME 中超联赛]]
明天去纽约的航班。	[IN:QUERY [SL:STARTDATE_DATE 明天]去[SL:ENDLOC_CITY 纽约]的航班。]
中超的比赛时间。	[IN:QUERY [SL:CATEGORY 中超]的比赛时间。]
腾讯公司的股票	[IN:QUERY [SL:NAME 腾讯]公司的股票]
给我放一部最新的电影。	[IN:QUERY 给我放一部最新的电影。]
BTV北京频道打狗棍	[IN:QUERY [SL:TVCHANNEL BTV北京频道][SL:NAME 打狗棍]]
大乐透中奖号码为	[IN:NUMBER_QUERY [SL:NAME 大乐透]中奖号码为]
打开个性闹钟	[IN:LAUNCH 打开[SL:NAME 个性闹钟]]
做鱼怎么做？	[IN:QUERY 做[SL:INGREDIENT 鱼]怎么做？]
上海回合肥怎么坐汽车	[IN:QUERY [SL:SRC 上海]回[SL:DEST 合肥]怎么坐汽车]
发短信	[IN:SEND 发短信]
打电话给大哥	[IN:DIAL 打电话给[SL:NAME 大哥]]
去网上搜索兰陵王。	[IN:QUERY 去网上搜索[SL:NAME 兰陵王]。]
把高建清的号码发给潘青华	[IN:SENDCONTACTS 把[SL:NAME 高建清]的号码发给[SL:RECEIVER 潘青华]]
鱼怎么做莱	[IN:QUERY [SL:INGREDIENT 鱼]怎么做莱]
我想看搞定岳父大人电影	[IN:QUERY 我想看[SL:NAME 搞定岳父大人][SL:CATEGORY 电影]]
你去玩手机了吧用英语怎么说	[IN:TRANSLATION [SL:CONTENT 你去玩手机了吧]用[SL:TARGET 英语]怎么说]
给我看看什么时候有播盛夏晚晴天	[IN:QUERY 给我看看什么时候有播[SL:NAME 盛夏晚晴天]]
螃蟹怎么蒸？	[IN:QUERY [SL:INGREDIENT 螃蟹]怎么蒸？]
汉堡。	[IN:QUERY [SL:DISHNAME 汉堡]。]
红烧猪脚怎么做啊？	[IN:QUERY [SL:DISHNAME 红烧猪脚]怎么做啊？]
搜索合肥左岸电影城。	[IN:QUERY 搜索[SL:THEATRE 合肥左岸电影城]。]
CCTV新闻	[IN:PLAY [SL:NAME CCTV新闻]]
我想看大武当电影	[IN:QUERY 我想看[SL:NAME 大武当][SL:CATEGORY 电影]]
从我这里去芙蓉区政府怎么去	[IN:ROUTE 从我这里去[SL:ENDLOC_POI 芙蓉区政府]怎么去]
易车网看看	[IN:OPEN [SL:NAME 易车网]看看]
肉肉怎么腌制？	[IN:QUERY [SL:INGREDIENT 肉肉]怎么腌制？]
说萝卜怎么做？	[IN:QUERY 说[SL:INGREDIENT 萝卜]怎么做？]
查一首古诗，武林春。	[IN:QUERY 查一首古诗，[SL:NAME 武林春]。]
阳澄湖大闸蟹的做法。	[IN:QUERY [SL:DISHNAME 阳澄湖大闸蟹]的做法。]
写短信给颖村	[IN:SEND 写短信给[SL:NAME 颖村]]
艺锅肉怎么做？	[IN:QUERY 艺锅[SL:INGREDIENT 肉]怎么做？]
从汕头到西安的汽车。	[IN:QUERY 从[SL:SRC 汕头]到[SL:DEST 西安]的汽车。]
发信息给学超	[IN:SEND 发信息给[SL:NAME 学超]]
甲鱼，邓鸡，如何制作。	[IN:QUERY 甲鱼，邓[SL:INGREDIENT 鸡]，如何制作。]
大骨汤的做法。	[IN:QUERY [SL:INGREDIENT 大骨汤]的做法。]
去永康怎么走	[IN:ROUTE 去[SL:ENDLOC_AREA 永康]怎么走]
麻烦您可不可以帮我调频99.3嘉善人民广播电台	[IN:LAUNCH 麻烦您可不可以帮我调频[SL:CODE 99.3][SL:NAME 嘉善人民广播电台]]
我要和妹妹睡觉英语怎么说	[IN:TRANSLATION [SL:CONTENT 我要和妹妹睡觉][SL:TARGET 英语]怎么说]
黑米红豆粥的做法。	[IN:QUERY [SL:DISHNAME 黑米红豆粥]的做法。]
chc高清的节目单	[IN:QUERY [SL:TVCHANNEL chc高清]的节目单]
土豆炒肉丝的做法	[IN:QUERY [SL:DISHNAME 土豆炒肉丝]的做法]
给刘西发短信	[IN:SEND 给[SL:NAME 刘西]发短信]
板栗如何烧？	[IN:QUERY [SL:INGREDIENT 板栗]如何烧？]
海星的做法。	[IN:QUERY [SL:INGREDIENT 海星]的做法。]
智能手机英语怎么说	[IN:TRANSLATION [SL:CONTENT 智能手机][SL:TARGET 英语]怎么说]
神兵小将	[IN:QUERY [SL:NAME 神兵小将]]
播七龙珠	[IN:QUERY 播[SL:NAME 七龙珠]]
酸菜鱼怎么煮啊？	[IN:QUERY [SL:DISHNAME 酸菜鱼]怎么煮啊？]
翻译这个多少钱	[IN:TRANSLATION 翻译[SL:CONTENT 这个多少钱]]
我想知道皮蛋瘦肉粥是怎么做的	[IN:QUERY 我想知道[SL:DISHNAME 皮蛋瘦肉粥]是怎么做的]
下半年的电视剧	[IN:QUERY [SL:DATETIME_DATE 下半年]的[SL:CATEGORY 电视剧]]
看动物卡通	[IN:QUERY 看[SL:TAG 动物卡通]]
导航到佛山大良汽车站	[IN:ROUTE 导航到[SL:ENDLOC_CITY 佛山]大良汽车站]
宜家	[IN:OPEN [SL:NAME 宜家]]
蒋捷的宋词	[IN:QUERY [SL:AUTHOR 蒋捷]的[SL:DYNASTY 宋]词]
请帮我调一下电台到镇江新闻广播	[IN:LAUNCH 请帮我调一下电台到[SL:NAME 镇江新闻广播]]
灌阳县位置	[IN:POSITION [SL:LOCATION_AREA 灌阳县]位置]
酷狗音乐盒	[IN:LAUNCH [SL:NAME 酷狗音乐盒]]
发短讯给曹建阳	[IN:SEND 发短讯给[SL:NAME 曹建阳]]
家，背首沁园春雪。	[IN:QUERY 家，背首[SL:NAME 沁园春雪]。]
我想看一下科大讯飞的股票	[IN:QUERY 我想看一下[SL:NAME 科大讯飞]的股票]
我想上qq	[IN:LAUNCH 我想上[SL:NAME qq]]
灌汤小笼包怎样做。	[IN:QUERY [SL:DISHNAME 灌汤小笼包]怎样做。]
西红柿用英语怎么说	[IN:TRANSLATION [SL:CONTENT 西红柿]用[SL:TARGET 英语]怎么说]
馄炖怎么做？	[IN:QUERY [SL:DISHNAME 馄炖]怎么做？]
汉堡的英语怎么说	[IN:TRANSLATION [SL:CONTENT 汉堡]的[SL:TARGET 英语]怎么说]
电影中国合伙人	[IN:QUERY [SL:CATEGORY 电影][SL:NAME 中国合伙人]]
请背诵静夜思。	[IN:QUERY 请背诵[SL:NAME 静夜思]。]
中央六台的节目单	[IN:QUERY [SL:TVCHANNEL 中央六台]的节目单]
我想听最新军事新闻。	[IN:PLAY 我想听最新[SL:CATEGORY 军事]新闻。]
朗诵一首李白的诗词。	[IN:QUERY 朗诵一首[SL:AUTHOR 李白]的诗词。]
帮忙打开一下酷狗音乐播放音乐行不	[IN:LAUNCH 帮忙打开一下[SL:NAME 酷狗音乐]播放音乐行不]
死亡笔记	[IN:QUERY [SL:NAME 死亡笔记]]
字谜你。	[IN:QUERY [SL:CATEGORY 字谜]你。]
给夏磊发短信	[IN:SEND 给[SL:NAME 夏磊]发短信]
乳房的英语怎么说	[IN:TRANSLATION [SL:CONTENT 乳房]的[SL:TARGET 英语]怎么说]
夜访吸血鬼	[IN:QUERY [SL:NAME 夜访吸血鬼]]
得了关节炎怎么办？	[IN:QUERY 得了[SL:KEYWORD 关节炎]怎么办？]
有没有下周二到贵阳的航班	[IN:QUERY 有没有[SL:STARTDATE_DATE 下周二]到[SL:ENDLOC_CITY 贵阳]的航班]
电影十二生肖	[IN:QUERY [SL:CATEGORY 电影][SL:NAME 十二生肖]]
打开腾讯拍拍网	[IN:OPEN 打开[SL:NAME 腾讯拍拍网]]
今天什么好看电影？	[IN:QUERY [SL:DATETIME_DATE 今天]什么好看[SL:CATEGORY 电影]？]
炒鸡蛋，需要，哪些材料？	[IN:QUERY [SL:DISHNAME 炒鸡蛋]，需要，哪些材料？]
土豆烧肉。	[IN:QUERY [SL:DISHNAME 土豆烧肉]。]
我要点一首小星星	[IN:PLAY 我要点一首[SL:SONG 小星星]]
添加一条通讯录姓名葛勇手机号码189571642496	[IN:CREATE 添加一条通讯录姓名[SL:NAME 葛勇]手机号码[SL:CODE 189571642496]]
铁甲钢拳	[IN:QUERY [SL:NAME 铁甲钢拳]]
我想答复这个邮件	[IN:REPLY 我想答复这个邮件]
怎么治感冒？	[IN:QUERY 怎么治[SL:KEYWORD 感冒]？]
来首我的未来不是梦	[IN:PLAY 来首[SL:SONG 我的未来不是梦]]
胆结石怎样治疗。	[IN:QUERY [SL:KEYWORD 胆结石]怎样治疗。]
肩周炎，要怎么治疗。	[IN:QUERY [SL:KEYWORD 肩周炎]，要怎么治疗。]
分手时，背一首诗吧？	[IN:DEFAULT 分手时，背一首诗吧？]
播放歌曲再见青春	[IN:PLAY 播放歌曲[SL:SONG 再见青春]]
一起听听新疆人民广播电台	[IN:LAUNCH 一起听听[SL:NAME 新疆人民广播电台]]
背唐诗李白侠客行	[IN:QUERY 背[SL:DYNASTY 唐]诗[SL:AUTHOR 李白][SL:NAME 侠客行]]
新闻解码	[IN:PLAY [SL:NAME 新闻解码]]
你知道中国科技大学在哪里吗	[IN:POSITION 你知道[SL:LOCATION_POI 中国科技大学]在哪里吗]
书画频道上周六有开始非诚勿扰么	[IN:QUERY [SL:TVCHANNEL 书画频道][SL:DATETIME_DATE 上周六]有开始[SL:NAME 非诚勿扰]么]
我好想听新城知讯台	[IN:LAUNCH 我好想听[SL:NAME 新城知讯台]]
老朗诵首古诗。	[IN:DEFAULT 老朗诵首古诗。]
我要买彩票。	[IN:QUERY 我要买彩票。]
帮我来一首兰陵王。	[IN:QUERY 帮我来一首[SL:NAME 兰陵王]。]
转发这条mail	[IN:FORWARD 转发这条mail]
木瓜汤怎么做	[IN:QUERY [SL:DISHNAME 木瓜汤]怎么做]
搜王菲演唱会	[IN:QUERY 搜[SL:ARTIST 王菲][SL:TAG 演唱会]]
天最新新闻。	[IN:PLAY 天最新新闻。]
咳嗽怎么办	[IN:QUERY [SL:KEYWORD 咳嗽]怎么办]
猪肉丸子汤怎么做啊？	[IN:QUERY [SL:DISHNAME 猪肉丸子汤]怎么做啊？]
恶念首唐诗。	[IN:QUERY 恶念首[SL:DYNASTY 唐]诗。]
请告诉我清蒸桂鱼怎么做？	[IN:QUERY 请告诉我[SL:DISHNAME 清蒸桂鱼]怎么做？]
生活大爆炸	[IN:QUERY [SL:NAME 生活大爆炸]]
李瑞英主持的最新的新闻节目	[IN:QUERY [SL:ARTIST 李瑞英][SL:ARTISTROLE 主持]的[SL:TIMEDESCR 最新]的[SL:TAG 新闻][SL:CATEGORY 节目]]
西红柿炒鸡蛋做法。	[IN:QUERY [SL:DISHNAME 西红柿炒鸡蛋]做法。]
面包怎么做	[IN:QUERY [SL:DISHNAME 面包]怎么做]
看东方	[IN:QUERY 看[SL:NAME 东方]]
打开熊猫看书	[IN:LAUNCH 打开[SL:NAME 熊猫看书]]
我背一下春晓。	[IN:QUERY 我背一下[SL:NAME 春晓]。]
鹰潭到景德镇	[IN:ROUTE [SL:STARTLOC_CITY 鹰潭]到[SL:ENDLOC_CITY 景德镇]]
音乐播放器	[IN:LAUNCH [SL:NAME 音乐播放器]]
怎么做炸鸡	[IN:QUERY 怎么做[SL:DISHNAME 炸鸡]]
我要答复邮件	[IN:REPLY 我要答复邮件]
我想听回锅肉做法。	[IN:QUERY 我想听[SL:DISHNAME 回锅肉]做法。]
我想听笨这首歌。	[IN:PLAY 我想听[SL:SONG 笨]这首歌。]
无锡到阜阳怎么坐汽车？	[IN:QUERY [SL:SRC 无锡]到[SL:DEST 阜阳]怎么坐汽车？]
从合肥到上海可以到哪坐车？	[IN:QUERY 从[SL:SRC 合肥]到[SL:DEST 上海]可以到哪坐车？]
代码000800的股票涨幅是多少	[IN:RISERATE_QUERY 代码[SL:CODE 000800]的股票涨幅是多少]
占田你给我放一下最近的新闻。	[IN:PLAY 占田你给我放一下[SL:DATETIME_DATE 最近]的新闻。]
北京二	[IN:PLAY [SL:NAME 北京二]]
中国新华网打开	[IN:OPEN 中国[SL:NAME 新华网]打开]
查找90年代好评的武侠电影	[IN:QUERY 查找[SL:DECADE 90年代][SL:PAYMENT 好评]的[SL:TAG 武侠][SL:CATEGORY 电影]]
查询上海到北京的航班。	[IN:QUERY 查询[SL:STARTLOC_CITY 上海]到[SL:ENDLOC_CITY 北京]的航班。]
哦哦，最新的电影。	[IN:QUERY 哦哦，最新的电影。]
红烧猪脚	[IN:QUERY [SL:DISHNAME 红烧猪脚]]
帮我查一下我所在的位置	[IN:POSITION 帮我查一下我所在的位置]
熊出没啊	[IN:QUERY [SL:NAME 熊出没]啊]
请给我讲一下今天的新闻吧！	[IN:PLAY 请给我讲一下[SL:DATETIME_DATE 今天]的新闻吧！]
查查科大讯飞在哪儿	[IN:POSITION 查查[SL:LOCATION_POI 科大讯飞]在哪儿]
帮我翻译一下我饿了	[IN:TRANSLATION 帮我翻译一下[SL:CONTENT 我饿了]]
白灼基尾虾的做法。	[IN:QUERY [SL:DISHNAME 白灼基尾虾]的做法。]
背首杜甫的诗啊？	[IN:QUERY 背首[SL:AUTHOR 杜甫]的诗啊？]
桂花糕。	[IN:QUERY [SL:DISHNAME 桂花糕]。]
我要查看邮件	[IN:LAUNCH 我要查看邮件]
哦哦，查一下香港最新上映电影。	[IN:QUERY 哦哦，查一下[SL:LOCATION_CITY 香港]最新上映电影。]
给我来首绝句。	[IN:QUERY 给我来首[SL:NAME 绝句]。]
讲个谜语吧，辣。	[IN:QUERY 讲个[SL:CATEGORY 谜语]吧，辣。]
明晚真人秀频道有播放过百变大咖秀呢	[IN:QUERY [SL:DATETIME_TIME 明晚][SL:TVCHANNEL 真人秀频道]有播放过[SL:NAME 百变大咖秀]呢]
背首静夜思来听一下。	[IN:QUERY 背首[SL:NAME 静夜思]来听一下。]
看一下中式传媒股票的涨跌幅	[IN:RISERATE_QUERY 看一下[SL:NAME 中式传媒]股票的涨跌幅]
新建联系人18622625490	[IN:CREATE 新建联系人[SL:CODE 18622625490]]
陕西金叶近日的涨幅情况	[IN:RISERATE_QUERY [SL:NAME 陕西金叶]近日的涨幅情况]
好评的喜剧电影	[IN:QUERY [SL:SCOREDESCR 好评]的[SL:TAG 喜剧][SL:CATEGORY 电影]]
我想知道环球影视明天播放什么电影	[IN:QUERY 我想知道环球影视[SL:DATETIME_DATE 明天]播放什么电影]
湖南卫视现在演什么节目	[IN:QUERY [SL:TVCHANNEL 湖南卫视][SL:DATETIME_TIME 现在]演什么节目]
查一下南昌到南京的火车	[IN:QUERY 查一下[SL:STARTLOC_CITY 南昌]到[SL:ENDLOC_CITY 南京]的火车]
中超比赛，结果。	[IN:QUERY [SL:CATEGORY 中超]比赛，[SL:TYPE 结果]。]
打开天天动听播放站你名下	[IN:LAUNCH 打开[SL:NAME 天天动听]播放站你名下]
落花不是无情物的下一句是什么？	[IN:QUERY [SL:KEYWORD 落花不是无情物]的[SL:QUERYFIELD 下一句]是什么？]
打石宝电话	[IN:DIAL 打[SL:NAME 石宝]电话]
来一首纳兰性德的词。	[IN:QUERY 来一首[SL:AUTHOR 纳兰性德]的词。]
一千五英语怎么说	[IN:TRANSLATION [SL:CONTENT 一千五][SL:TARGET 英语]怎么说]
看看最近有什么电影？	[IN:QUERY 看看最近有什么电影？]
夫妻肺片怎么做？	[IN:QUERY [SL:DISHNAME 夫妻肺片]怎么做？]
发短信给刘文说明天下午五点有聚会	[IN:SEND 发短信给[SL:NAME 刘文]说[SL:CONTENT 明天下午五点有聚会]]
妖精的尾巴	[IN:QUERY [SL:NAME 妖精的尾巴]]
我要查彩票的开奖信息。	[IN:NUMBER_QUERY 我要查彩票的开奖信息。]
你能搜到小说不？	[IN:QUERY 你能搜到小说不？]
搜索中国共产党章程	[IN:QUERY 搜索[SL:NAME 中国共产党章程]]
打电话零八	[IN:DIAL 打电话零八]
请播放一下举起手来	[IN:QUERY 请播放一下[SL:NAME 举起手来]]
穷孩子富孩子	[IN:QUERY [SL:NAME 穷孩子富孩子]]
高淳转播2	[IN:PLAY [SL:NAME 高淳转播2]]
中海油服股票	[IN:QUERY [SL:NAME 中海油服]股票]
给王涛打电话	[IN:DIAL 给[SL:NAME 王涛]打电话]
开启雅虎	[IN:OPEN 开启[SL:NAME 雅虎]]
南昌到广州飞机票	[IN:QUERY [SL:STARTLOC_CITY 南昌]到[SL:ENDLOC_CITY 广州]飞机票]
查询临沂到济南的火车票	[IN:QUERY 查询[SL:STARTLOC_CITY 临沂]到[SL:ENDLOC_CITY 济南]的火车票]
现在打开你的官网	[IN:OPEN 现在打开[SL:NAME 你的官网]]
给张倩倩发短信	[IN:SEND 给[SL:NAME 张倩倩]发短信]
发短信给林晓云说我爱你	[IN:SEND 发短信给[SL:NAME 林晓云]说[SL:CONTENT 我爱你]]
你给我念一首李白的诗。	[IN:QUERY 你给我念一首[SL:AUTHOR 李白]的诗。]
一路向西	[IN:QUERY [SL:NAME 一路向西]]
到北京的火车班次	[IN:QUERY 到[SL:ENDLOC_CITY 北京]的火车班次]
天王盖地虎的下一句是什么？	[IN:QUERY [SL:KEYWORD 天王盖地虎]的[SL:QUERYFIELD 下一句]是什么？]
安徽电视台12月18号晚上10:10的电视剧	[IN:QUERY [SL:TVCHANNEL 安徽电视台]1[SL:DATETIME_DATE 2月18号][SL:DATETIME_TIME 晚上10:10]的[SL:CATEGORY 电视剧]]
刘三姐	[IN:QUERY [SL:NAME 刘三姐]]
看看大乐透的得奖号码	[IN:NUMBER_QUERY 看看[SL:NAME 大乐透]的得奖号码]
久久鸭怎么做？	[IN:QUERY [SL:DISHNAME 久久鸭]怎么做？]
我想看电影搜索	[IN:QUERY 我想看[SL:CATEGORY 电影][SL:NAME 搜索]]
蒽蒽江苏卫视有什么好节目吗？	[IN:QUERY 蒽蒽[SL:TVCHANNEL 江苏卫视]有什么好节目吗？]
从重庆到武汉的航班	[IN:QUERY 从[SL:STARTLOC_CITY 重庆]到[SL:ENDLOC_CITY 武汉]的航班]
看毛泽东在武汉的故事	[IN:QUERY 看[SL:NAME 毛泽东在武汉的故事]]
请打电话给沈晨浩	[IN:DIAL 请打电话给[SL:NAME 沈晨浩]]
鸡蛋怎么炒最好吃？	[IN:QUERY [SL:INGREDIENT 鸡蛋]怎么炒最好吃？]
启动qq浏览器	[IN:LAUNCH 启动[SL:NAME qq浏览器]]
背一下游子。	[IN:QUERY 背一下[SL:NAME 游子]。]
请打开网页	[IN:OPEN 请打开网页]
BTVKAKU少儿	[IN:PLAY [SL:NAME BTVKAKU少儿]]
胃炎怎么治？	[IN:QUERY [SL:KEYWORD 胃炎]怎么治？]
帮我在百度里搜一下东莞到北京的火车	[IN:QUERY 帮我在百度里搜一下[SL:STARTLOC_CITY 东莞]到[SL:ENDLOC_CITY 北京]的火车]
播放断点	[IN:PLAY 播放[SL:SONG 断点]]
念一首唐诗给我听。	[IN:QUERY 念一首[SL:DYNASTY 唐]诗给我听。]
chc高清电影昨天晚上的节目	[IN:QUERY [SL:TVCHANNEL chc高清电影][SL:DATETIME_DATE 昨天][SL:DATETIME_TIME 晚上]的节目]
我要听昆明新闻。	[IN:PLAY 我要听[SL:LOCATION_CITY 昆明]新闻。]
怎样做糖醋排骨时，去吃饭洗澡了。	[IN:QUERY 怎样做[SL:DISHNAME 糖醋排骨]时，去吃饭洗澡了。]
提供一张大乐透	[IN:NUMBER_QUERY 提供一张[SL:NAME 大乐透]]
美国热门的恐怖电影	[IN:QUERY [SL:AREA 美国][SL:POPULARITY 热门]的[SL:TAG 恐怖][SL:CATEGORY 电影]]
昭通到南昌的汽车。	[IN:QUERY [SL:SRC 昭通]到[SL:DEST 南昌]的汽车。]
打电话给卢静	[IN:DIAL 打电话给[SL:NAME 卢静]]
搜狗	[IN:LAUNCH [SL:NAME 搜狗]]
中央一套什么时候有建党伟业	[IN:QUERY [SL:TVCHANNEL 中央一套]什么时候有[SL:NAME 建党伟业]]
我要听劝化这首歌	[IN:PLAY 我要听[SL:SONG 劝化]这首歌]
打一下公司张总的电话	[IN:DIAL 打一下[SL:CATEGORY 公司][SL:NAME 张总]的电话]
总计今天的新闻。	[IN:PLAY 总计[SL:DATETIME_DATE 今天]的新闻。]
替我回复这封邮件	[IN:REPLY 替我回复这封邮件]
查一下杭州到宁波的火车票	[IN:QUERY 查一下[SL:STARTLOC_CITY 杭州]到[SL:ENDLOC_CITY 宁波]的火车票]
搜索中国移动的股市行情	[IN:QUERY 搜索[SL:NAME 中国移动]的股市行情]
酸辣汤的做法。	[IN:QUERY [SL:DISHNAME 酸辣汤]的做法。]
赶集	[IN:LAUNCH [SL:NAME 赶集]]
查询大北农的股票	[IN:QUERY 查询[SL:NAME 大北农]的股票]
搜索游戏	[IN:QUERY 搜索[SL:NAME 游戏]]
现在热门的电视剧是什么	[IN:QUERY 现在[SL:POPULARITY 热门]的[SL:CATEGORY 电视剧]是什么]
唇腭裂。	[IN:QUERY [SL:KEYWORD 唇腭裂]。]
来一首毛泽东的词。	[IN:QUERY 来一首[SL:AUTHOR 毛泽东]的词。]
看一下今天早上新闻。	[IN:PLAY 看一下[SL:DATETIME_DATE 今天][SL:DATETIME_TIME 早上]新闻。]
美女啊帮我打开网页	[IN:OPEN 美女啊帮我打开网页]
胖鱼头怎么烧？	[IN:QUERY [SL:INGREDIENT 胖鱼头]怎么烧？]
明天到郑州的火车	[IN:QUERY [SL:STARTDATE_DATE 明天]到[SL:ENDLOC_CITY 郑州]的火车]
世界军事中央台世界军事	[IN:QUERY [SL:NAME 世界军事][SL:TVCHANNEL 中央台][SL:NAME 世界军事]]
新东站怎么走	[IN:ROUTE [SL:ENDLOC_POI 新东站]怎么走]
科大讯飞今天的股票	[IN:QUERY [SL:NAME 科大讯飞]今天的股票]
给秦丽香发信息	[IN:SEND 给[SL:NAME 秦丽香]发信息]
睡觉用英文怎么说	[IN:TRANSLATION [SL:CONTENT 睡觉]用[SL:TARGET 英文]怎么说]
给我来首好听的音乐	[IN:PLAY 给我来首[SL:CATEGORY 好听]的音乐]
帮我查一下深圳到桂林后天的机票	[IN:QUERY 帮我查一下[SL:STARTLOC_CITY 深圳]到[SL:ENDLOC_CITY 桂林][SL:STARTDATE_DATE 后天]的机票]
北京到成都的汽车时刻表。	[IN:QUERY [SL:SRC 北京]到[SL:DEST 成都]的汽车时刻表。]
迎宾路在哪	[IN:POSITION [SL:LOCATION_POI 迎宾路]在哪]
帮我搜索一下有什么家常菜？	[IN:QUERY 帮我搜索一下有什么[SL:KEYWORD 家常菜]？]
给我查一下，乳腺增生怎么治疗？	[IN:QUERY 给我查一下，[SL:KEYWORD 乳腺增生]怎么治疗？]
打电话给地瓜	[IN:DIAL 打电话给[SL:NAME 地瓜]]
金瓶梅	[IN:QUERY [SL:NAME 金瓶梅]]
打开相机这	[IN:LAUNCH 打开[SL:NAME 相机]这]
请问一下军事新闻。	[IN:PLAY 请问一下[SL:CATEGORY 军事]新闻。]
聚友网	[IN:OPEN [SL:NAME 聚友网]]
我想听首歌	[IN:PLAY 我想听首歌]
炖肉	[IN:QUERY [SL:DISHNAME 炖肉]]
来首歌吗？	[IN:PLAY 来首歌吗？]
我要写一条邮件	[IN:CREATE 我要写一条邮件]
唱一首简单爱	[IN:PLAY 唱一首[SL:SONG 简单爱]]
宫外孕怎么办？	[IN:QUERY [SL:KEYWORD 宫外孕]怎么办？]
给我看新邮件	[IN:LAUNCH 给我看新邮件]
查询华峰氨纶的股票	[IN:QUERY 查询[SL:NAME 华峰氨纶]的股票]
来首纳兰性德的词。	[IN:QUERY 来首[SL:AUTHOR 纳兰性德]的词。]
我想听你最珍贵这首音乐	[IN:PLAY 我想听[SL:SONG 你最珍贵]这首音乐]
帮我搜一下中超3月份的对阵情况	[IN:QUERY 帮我搜一下[SL:CATEGORY 中超][SL:DATETIME_DATE 3月份]的对阵情况]
茄子鸡蛋怎么做？	[IN:QUERY [SL:DISHNAME 茄子鸡蛋]怎么做？]
韩国电视连续剧老大	[IN:QUERY [SL:AREA 韩国][SL:CATEGORY 电视连续剧][SL:NAME 老大]]
打开uc二哦	[IN:LAUNCH 打开[SL:NAME uc]二哦]
共同关注	[IN:QUERY [SL:NAME 共同关注]]
帮我查一下到狼牙山怎么走	[IN:ROUTE 帮我查一下到[SL:ENDLOC_POI 狼牙山]怎么走]
发送短信给东莞李月华就说今天赶紧回来	[IN:SEND 发送短信给[SL:NAME 东莞李月华]就说[SL:CONTENT 今天赶紧回来]]
给我讲一个谜语吧！	[IN:QUERY 给我讲一个[SL:CATEGORY 谜语]吧！]
馒头怎么做吗？	[IN:QUERY [SL:DISHNAME 馒头]怎么做吗？]
动画片巴啦啦小魔仙	[IN:QUERY [SL:TAG 动画][SL:CATEGORY 片][SL:NAME 巴啦啦小魔仙]]
讯飞语点我现在在哪里	[IN:POSITION 讯飞语点我现在在哪里]
打电话给陈正成	[IN:DIAL 打电话给[SL:NAME 陈正成]]
打开优酷视频	[IN:LAUNCH 打开[SL:NAME 优酷视频]]
到北京的飞机。	[IN:QUERY 到[SL:ENDLOC_CITY 北京]的飞机。]
冰激凌怎么做哦	[IN:QUERY [SL:DISHNAME 冰激凌]怎么做哦]
破伤风该怎么处理	[IN:QUERY [SL:KEYWORD 破伤风]该怎么处理]
王志排骨怎么做	[IN:QUERY 王志[SL:INGREDIENT 排骨]怎么做]
哦，听新闻。	[IN:PLAY 哦，听新闻。]
最新有什么热门电影	[IN:QUERY [SL:TIMEDESCR 最新]有什么[SL:POPULARITY 热门][SL:CATEGORY 电影]]
赛罗奥特曼	[IN:QUERY [SL:NAME 赛罗奥特曼]]
给我来首唐诗三百首。	[IN:QUERY 给我来首[SL:DYNASTY 唐]诗三百首。]
读心专家	[IN:QUERY [SL:NAME 读心专家]]
米粉怎么炒？	[IN:QUERY [SL:INGREDIENT 米粉]怎么炒？]
青岛海信股票	[IN:QUERY 青岛[SL:NAME 海信]股票]
桂林米粉，哦。	[IN:QUERY [SL:DISHNAME 桂林米粉]，哦。]
从广州到贵阳市的航班	[IN:QUERY 从[SL:STARTLOC_CITY 广州]到[SL:ENDLOC_CITY 贵阳]市的航班]
床英文怎么说	[IN:TRANSLATION [SL:CONTENT 床][SL:TARGET 英文]怎么说]
南京新闻频道	[IN:PLAY [SL:NAME 南京新闻频道]]
发短信给姐姐说晚上一起吃面条	[IN:SEND 发短信给[SL:NAME 姐姐]说[SL:CONTENT 晚上一起吃面条]]
惊情四百年	[IN:QUERY [SL:NAME 惊情四百年]]
哦，中超比赛时间三比五。	[IN:QUERY 哦，[SL:CATEGORY 中超]比赛时间三比五。]
可以找一下浪漫满屋的小说	[IN:QUERY 可以找一下[SL:NAME 浪漫满屋]的小说]
青岛到广州航班	[IN:QUERY [SL:STARTLOC_CITY 青岛]到[SL:ENDLOC_CITY 广州]航班]
现在电视台在播什么	[IN:QUERY [SL:DATETIME_TIME 现在]电视台在播什么]
来做烧卖。	[IN:QUERY 来做[SL:DISHNAME 烧卖]。]
风魔炒鱼香肉丝。	[IN:QUERY [SL:DISHNAME 风魔炒鱼香肉丝]。]
星期四去上海的火车	[IN:QUERY [SL:STARTDATE_DATE 星期四]去[SL:ENDLOC_CITY 上海]的火车]
保险，酸辣土豆丝怎么炒？	[IN:QUERY 保险，[SL:DISHNAME 酸辣土豆丝]怎么炒？]
忍者之路	[IN:QUERY [SL:NAME 忍者之路]]
13年的电影	[IN:QUERY [SL:DATETIME_DATE 13年]的[SL:CATEGORY 电影]]
湖北电视台高清	[IN:PLAY [SL:NAME 湖北电视台][SL:RESOLUTION 高清]]
来时打来首唐诗绝句。	[IN:QUERY 来时打来首[SL:DYNASTY 唐]诗[SL:NAME 绝句]。]
地心历险记二	[IN:QUERY [SL:NAME 地心历险记二]]
打开应用程序钱包	[IN:LAUNCH 打开应用程序[SL:NAME 钱包]]
蒜苔的做法	[IN:QUERY [SL:INGREDIENT 蒜苔]的做法]
发短信给张三说“画皮2在哪个台播出”	[IN:SEND 发短信给[SL:NAME 张三]说“[SL:CONTENT 画皮2在哪个台播出]”]
九月二十号广州飞北京的航班	[IN:QUERY [SL:STARTDATE_DATE 九月二十号][SL:STARTLOC_CITY 广州]飞[SL:ENDLOC_CITY 北京]的航班]
你今天去了哪里用英文怎么讲	[IN:TRANSLATION [SL:CONTENT 你今天去了哪里]用[SL:TARGET 英文]怎么讲]
CCTV9明晚有转播仁心解码2呢	[IN:QUERY [SL:TVCHANNEL CCTV9][SL:DATETIME_TIME 明晚]有转播[SL:NAME 仁心解码2]呢]
今天是个好日子的英文怎么讲	[IN:TRANSLATION [SL:CONTENT 今天是个好日子]的[SL:TARGET 英文]怎么讲]
长风吹月渡海来下一句是什么？	[IN:QUERY [SL:KEYWORD 长风吹月渡海来][SL:QUERYFIELD 下一句]是什么？]
今天的天气真是好用英语怎么说	[IN:TRANSLATION [SL:CONTENT 今天的天气真是好]用[SL:TARGET 英语]怎么说]
我朗诵唐诗。	[IN:QUERY 我朗诵[SL:DYNASTY 唐]诗。]
打一个谜语男人的腿残。	[IN:QUERY 打一个[SL:CATEGORY 谜语]男人的腿残。]
梅菜扣肉怎么做啊？	[IN:QUERY [SL:DISHNAME 梅菜扣肉]怎么做啊？]
草莓芒果西米露。	[IN:QUERY [SL:DISHNAME 草莓芒果西米露]。]
搜索极品天王	[IN:QUERY 搜索[SL:NAME 极品天王]]
明天广州到长葛的火车	[IN:QUERY [SL:STARTDATE_DATE 明天][SL:STARTLOC_CITY 广州]到[SL:ENDLOC_AREA 长葛]的火车]
宫爆鸡丁的菜谱。	[IN:QUERY [SL:DISHNAME 宫爆鸡丁]的菜谱。]
中水渔业的股票	[IN:QUERY [SL:NAME 中水渔业]的股票]
我想看一下凤凰网	[IN:OPEN 我想看一下[SL:NAME 凤凰网]]
我想要全部答复	[IN:REPLAY_ALL 我想要全部答复]
到薛城区怎么走	[IN:ROUTE 到[SL:ENDLOC_AREA 薛城区]怎么走]
春熙路怎么走	[IN:ROUTE [SL:ENDLOC_POI 春熙路]怎么走]
给小阳发短信	[IN:SEND 给[SL:NAME 小阳]发短信]
湖南卫视放什么节目？	[IN:QUERY [SL:TVCHANNEL 湖南卫视]放什么节目？]
查寻科大讯飞的股	[IN:QUERY 查寻[SL:NAME 科大讯飞]的股]
广州到孝感的火车	[IN:QUERY [SL:STARTLOC_CITY 广州]到[SL:ENDLOC_CITY 孝感]的火车]
白面粉可以怎样做饼？	[IN:QUERY 白面粉可以怎样做[SL:INGREDIENT 饼]？]
昨天恒大比赛结果是什么？	[IN:QUERY [SL:DATETIME_DATE 昨天][SL:NAME 恒大]比赛[SL:TYPE 结果]是什么？]
鱼香肉丝，怎么做？买？	[IN:QUERY [SL:DISHNAME 鱼香肉丝]，怎么做？买？]
有什么重要新闻吗？	[IN:PLAY 有什么[SL:CATEGORY 重要]新闻吗？]
毛阿敏的歌	[IN:PLAY [SL:ARTIST 毛阿敏]的歌]
搜索最新新闻	[IN:PLAY 搜索[SL:KEYWORD 最新]新闻]
上山居网	[IN:OPEN 上[SL:NAME 山居网]]
牛肉怎么煮才好吃？你？	[IN:QUERY [SL:INGREDIENT 牛肉]怎么煮才好吃？你？]
查询昆明到合肥的火车	[IN:QUERY 查询[SL:STARTLOC_CITY 昆明]到[SL:ENDLOC_CITY 合肥]的火车]
我想吃汉堡包的英文怎么说	[IN:TRANSLATION [SL:CONTENT 我想吃汉堡包]的[SL:TARGET 英文]怎么说]
中超赛事预告吗？	[IN:QUERY [SL:CATEGORY 中超]赛事预告吗？]
米饭怎么做	[IN:QUERY [SL:DISHNAME 米饭]怎么做]
明天有火车到襄阳吗	[IN:QUERY [SL:STARTDATE_DATE 明天]有火车到[SL:ENDLOC_CITY 襄阳]吗]
平安保险的股票价格	[IN:QUERY [SL:NAME 平安保险]的股票价格]
肉炒饭怎么做？	[IN:QUERY [SL:DISHNAME 肉炒饭]怎么做？]
猫眼三姐妹	[IN:QUERY [SL:NAME 猫眼三姐妹]]
新浪汽车	[IN:OPEN [SL:NAME 新浪汽车]]
打电话温正军	[IN:DIAL 打电话[SL:NAME 温正军]]
打开安徽交通台	[IN:LAUNCH 打开[SL:NAME 安徽交通台]]
我要看饶雪漫的小说左耳	[IN:QUERY 我要看[SL:AUTHOR 饶雪漫]的小说[SL:NAME 左耳]]
情景剧电视剧	[IN:QUERY [SL:TAG 情景]剧[SL:CATEGORY 电视剧]]
近视眼怎么治疗	[IN:QUERY [SL:KEYWORD 近视眼]怎么治疗]
人造鸡蛋的配方。	[IN:QUERY [SL:DISHNAME 人造鸡蛋]的配方。]
伊利股份	[IN:QUERY [SL:NAME 伊利股份]]
东方高清台的节目单	[IN:QUERY [SL:TVCHANNEL 东方高清台]的节目单]
到鼓楼怎么走	[IN:ROUTE 到[SL:ENDLOC_AREA 鼓楼]怎么走]
翻译我是一只狗	[IN:TRANSLATION 翻译[SL:CONTENT 我是一只狗]]
我想听听钓鱼岛的新闻。	[IN:PLAY 我想听听[SL:KEYWORD 钓鱼岛]的新闻。]
答复，我要听新闻。	[IN:PLAY 答复，我要听新闻。]
读首唐诗	[IN:QUERY 读首[SL:DYNASTY 唐]诗]
打开搜狐网首页	[IN:OPEN 打开[SL:NAME 搜狐网]首页]
恒宇乐活鱼怎么做的好吃的回复哦，你。	[IN:QUERY 恒宇乐[SL:INGREDIENT 活鱼]怎么做的好吃的回复哦，你。]
背一首李白的诗来听听。	[IN:QUERY 背一首[SL:AUTHOR 李白]的诗来听听。]
查看七乐彩的得奖号码	[IN:NUMBER_QUERY 查看[SL:NAME 七乐彩]的得奖号码]
招商银行港股的股价	[IN:QUERY [SL:NAME 招商银行]港股的股价]
打开淘宝购物	[IN:LAUNCH 打开[SL:NAME 淘宝购物]]
查询武汉到茂名的火车	[IN:QUERY 查询[SL:STARTLOC_CITY 武汉]到[SL:ENDLOC_CITY 茂名]的火车]
机票	[IN:QUERY 机票]
歌曲白天不懂夜的黑	[IN:PLAY 歌曲[SL:SONG 白天不懂夜的黑]]
查找电影	[IN:QUERY 查找[SL:CATEGORY 电影]]
给我查一下糖尿病如何治疗？	[IN:QUERY 给我查一下[SL:KEYWORD 糖尿病]如何治疗？]
中国移动通信的英语怎么说	[IN:TRANSLATION [SL:CONTENT 中国移动通信]的[SL:TARGET 英语]怎么说]
来一首不可以。	[IN:PLAY 来一首[SL:SONG 不可以]。]
真达林业的股票怎么样	[IN:QUERY [SL:NAME 真达林业]的股票怎么样]
花开半夏	[IN:QUERY [SL:NAME 花开半夏]]
北京青年频道谁在说	[IN:QUERY [SL:TVCHANNEL 北京青年频道][SL:NAME 谁在说]]
甲亢怎么办？	[IN:QUERY [SL:KEYWORD 甲亢]怎么办？]
来一首琵琶行。	[IN:QUERY 来一首[SL:NAME 琵琶行]。]
浙江高清台的节目单	[IN:QUERY [SL:TVCHANNEL 浙江高清台]的节目单]
诗词满江红。	[IN:QUERY 诗词[SL:NAME 满江红]。]
你好啊，再背首诗。	[IN:DEFAULT 你好啊，再背首诗。]
放鱼怎么做？	[IN:QUERY 放[SL:INGREDIENT 鱼]怎么做？]
看一下今天晚上广西台有没有警戒线？	[IN:QUERY 看一下[SL:DATETIME_DATE 今天][SL:DATETIME_TIME 晚上][SL:TVCHANNEL 广西台]有没有[SL:NAME 警戒线]？]
红烧肉怎么煮啊	[IN:QUERY [SL:DISHNAME 红烧肉]怎么煮啊]
那你告诉我最新的热门电影吧。	[IN:QUERY 那你告诉我最新的热门电影吧。]
中超赛事预告，你。	[IN:QUERY [SL:CATEGORY 中超]赛事[SL:TYPE 预告]，你。]
周口在哪里	[IN:POSITION [SL:LOCATION_CITY 周口]在哪里]
帮我打开步步惊心	[IN:QUERY 帮我打开[SL:NAME 步步惊心]]
查询安阳到郑州的动车	[IN:QUERY 查询[SL:STARTLOC_CITY 安阳]到[SL:ENDLOC_CITY 郑州]的[SL:CATEGORY 动车]]
今天电影频道演什么	[IN:QUERY [SL:DATETIME_DATE 今天][SL:TVCHANNEL 电影频道]演什么]
若相惜不弃下一句是什么？	[IN:QUERY [SL:KEYWORD 若相惜不弃][SL:QUERYFIELD 下一句]是什么？]
想做蛋糕。	[IN:QUERY 想做[SL:DISHNAME 蛋糕]。]
江苏阳光的股票怎么样了	[IN:QUERY [SL:NAME 江苏阳光]的股票怎么样了]
什么电视台什么时间有转播仁心解码2	[IN:QUERY 什么电视台什么时间有转播[SL:NAME 仁心解码2]]
放歌，天亮了。	[IN:PLAY 放歌，[SL:SONG 天亮了]。]
安徽综艺	[IN:PLAY [SL:NAME 安徽综艺]]
我去杨家坪该怎么走	[IN:ROUTE 我去[SL:ENDLOC_POI 杨家坪]该怎么走]
科大讯飞股票价格	[IN:QUERY [SL:NAME 科大讯飞]股票价格]
痛经。	[IN:QUERY [SL:KEYWORD 痛经]。]
现在有什么好看的电视剧？	[IN:QUERY 现在有什么[SL:SCOREDESCR 好看]的[SL:CATEGORY 电视剧]？]
搜索西红柿的做法。	[IN:QUERY 搜索[SL:INGREDIENT 西红柿]的做法。]
美国电影少年派的奇幻漂流	[IN:QUERY [SL:AREA 美国][SL:CATEGORY 电影][SL:NAME 少年派的奇幻漂流]]
启动浏览器	[IN:LAUNCH 启动[SL:NAME 浏览器]]
查看大乐透玩法的开奖	[IN:NUMBER_QUERY 查看[SL:NAME 大乐透]玩法的开奖]
玄幻小说《武动乾坤》	[IN:QUERY [SL:CATEGORY 玄幻]小说《[SL:NAME 武动乾坤]》]
郭敬明的爱情小说《悲伤逆流成河》	[IN:QUERY [SL:AUTHOR 郭敬明]的[SL:CATEGORY 爱情]小说《[SL:NAME 悲伤逆流成河]》]
青海卫视频道的节目单	[IN:QUERY [SL:TVCHANNEL 青海卫视]频道的节目单]
开微信	[IN:LAUNCH 开[SL:NAME 微信]]
思春夜喜雨下一句是。	[IN:QUERY [SL:KEYWORD 思春夜喜雨][SL:QUERYFIELD 下一句]是。]
我要看西游记啊	[IN:QUERY 我要看[SL:NAME 西游记]啊]
怎么煮面才好吃呢？	[IN:QUERY 怎么[SL:DISHNAME 煮面]才好吃呢？]
给我打开一下qq	[IN:LAUNCH 给我打开一下[SL:NAME qq]]
说话，给我搜一下做苹果麦片粥是怎么做啊？	[IN:QUERY 说话，给我搜一下做[SL:DISHNAME 苹果麦片粥]是怎么做啊？]
电焊机用英语怎么说	[IN:TRANSLATION [SL:CONTENT 电焊机]用[SL:TARGET 英语]怎么说]
小军儿炖土豆该怎么做？	[IN:QUERY 小军儿[SL:DISHNAME 炖土豆]该怎么做？]
武汉卓尔的赛程。	[IN:QUERY [SL:NAME 武汉卓尔]的赛程。]
我去烟台有高铁吗	[IN:QUERY 我去[SL:ENDLOC_CITY 烟台]有[SL:CATEGORY 高铁]吗]
大薯条怎么做？	[IN:QUERY 大[SL:DISHNAME 薯条]怎么做？]
发短信给王曼希望你幸福	[IN:SEND 发短信给[SL:NAME 王曼]希望你幸福]
十堰至武汉火车票	[IN:QUERY [SL:STARTLOC_CITY 十堰]至[SL:ENDLOC_CITY 武汉]火车票]
今天有什么军事新闻	[IN:PLAY [SL:DATETIME_DATE 今天]有什么[SL:CATEGORY 军事]新闻]
你会不会做蛋糕只能回答哦。	[IN:QUERY 你会不会做[SL:DISHNAME 蛋糕]只能回答哦。]
背诵一首唐诗	[IN:QUERY 背诵一首[SL:DYNASTY 唐]诗]
打电话给奥巴马	[IN:DIAL 打电话给[SL:NAME 奥巴马]]
呼叫a 二小姐	[IN:DIAL 呼叫a [SL:NAME 二小姐]]
我听首歌	[IN:PLAY 我听首歌]
《武动乾坤》	[IN:QUERY 《[SL:NAME 武动乾坤]》]
请给我打一个谜语。	[IN:QUERY 请给我打一个[SL:CATEGORY 谜语]。]
青椒肉丝怎么做怎么炒？	[IN:QUERY [SL:DISHNAME 青椒肉丝]怎么做怎么炒？]
查询柳州到昆明的列车	[IN:QUERY 查询[SL:STARTLOC_CITY 柳州]到[SL:ENDLOC_CITY 昆明]的列车]
来首宋词。	[IN:QUERY 来首[SL:DYNASTY 宋]词。]
上海飞往北京的航班	[IN:QUERY [SL:STARTLOC_CITY 上海]飞往[SL:ENDLOC_CITY 北京]的航班]
头晕该怎么办？	[IN:QUERY [SL:KEYWORD 头晕]该怎么办？]
钓鱼岛新闻	[IN:PLAY [SL:KEYWORD 钓鱼岛]新闻]
帮我查一下明天广州到长沙的航班	[IN:QUERY 帮我查一下[SL:STARTDATE_DATE 明天][SL:STARTLOC_CITY 广州]到[SL:ENDLOC_CITY 长沙]的航班]
背一下春晓孟浩然。	[IN:QUERY 背一下[SL:NAME 春晓][SL:AUTHOR 孟浩然]。]
深圳至合肥的火车票	[IN:QUERY [SL:STARTLOC_CITY 深圳]至[SL:ENDLOC_CITY 合肥]的火车票]
妈妈的花样年华	[IN:QUERY [SL:NAME 妈妈的花样年华]]
最近有什么好看得	[IN:QUERY [SL:TIMEDESCR 最近]有什么[SL:SCOREDESCR 好看]得]
说个李白的诗来听听。	[IN:QUERY 说个[SL:AUTHOR 李白]的诗来听听。]
哪些台在放电影	[IN:QUERY 哪些台在放[SL:CATEGORY 电影]]
酸菜鱼的做法，妈。	[IN:QUERY [SL:DISHNAME 酸菜鱼]的做法，妈。]
雄关漫道真如铁下一句是什么？	[IN:QUERY [SL:KEYWORD 雄关漫道真如铁][SL:QUERYFIELD 下一句]是什么？]
急性胃肠炎。	[IN:QUERY [SL:KEYWORD 急性胃肠炎]。]
到武汉的航班	[IN:QUERY 到[SL:ENDLOC_CITY 武汉]的航班]
烧鸡块怎么做？	[IN:QUERY 烧[SL:INGREDIENT 鸡块]怎么做？]
央视9	[IN:PLAY [SL:NAME 央视9]]
胃溃疡。	[IN:QUERY [SL:KEYWORD 胃溃疡]。]
国画怎样做土豆烧鸡块	[IN:QUERY 国画怎样做[SL:DISHNAME 土豆烧鸡块]]
打开杜鑫文的网站	[IN:OPEN 打开[SL:NAME 杜鑫文的网站]]
我想写一个新邮件	[IN:CREATE 我想写一个新邮件]
哈哈，吃了水煮鱼怎么做？	[IN:QUERY 哈哈，吃了[SL:DISHNAME 水煮鱼]怎么做？]
我要看古典仙侠小说	[IN:QUERY 我要看[SL:CATEGORY 古典仙侠]小说]
明天晚上湖南卫视演什么电视剧	[IN:QUERY [SL:DATETIME_DATE 明天][SL:DATETIME_TIME 晚上][SL:TVCHANNEL 湖南卫视]演什么[SL:CATEGORY 电视剧]]
小兵张嘎电影儿	[IN:QUERY [SL:NAME 小兵张嘎][SL:CATEGORY 电影]儿]
中超比赛。	[IN:QUERY [SL:CATEGORY 中超]比赛。]
喂喂那个我说想听音乐呢	[IN:PLAY 喂喂那个我说想听音乐呢]
水果沙拉怎么做？	[IN:QUERY [SL:DISHNAME 水果沙拉]怎么做？]
刘林面怎么做啊？	[IN:QUERY 刘林[SL:INGREDIENT 面]怎么做啊？]
放首歌给我听吧	[IN:PLAY 放首歌给我听吧]
煲鸡汤。	[IN:QUERY [SL:DISHNAME 煲鸡汤]。]
中央四频道火箭兜风	[IN:QUERY [SL:TVCHANNEL 中央四频道][SL:NAME 火箭兜风]]
江苏教育台	[IN:PLAY [SL:NAME 江苏教育台]]
可以帮买火车票吗	[IN:QUERY 可以帮买火车票吗]
星光做西红柿炒鸡蛋呢！	[IN:QUERY 星光做[SL:DISHNAME 西红柿炒鸡蛋]呢！]
帮我打电话给港铁轮	[IN:DIAL 帮我打电话给[SL:NAME 港铁轮]]
读书频道上个星期五有播放新闻联播吗	[IN:QUERY [SL:TVCHANNEL 读书频道][SL:DATETIME_DATE 上个星期五]有播放[SL:NAME 新闻联播]吗]
把吴琪的电话号码发给妈咪	[IN:SENDCONTACTS 把[SL:NAME 吴琪]的电话号码发给[SL:RECEIVER 妈咪]]
来首山口。	[IN:QUERY 来首[SL:NAME 山口]。]
搜索娱乐新闻。	[IN:PLAY 搜索[SL:CATEGORY 娱乐]新闻。]
济南到重庆的航班。	[IN:QUERY [SL:STARTLOC_CITY 济南]到[SL:ENDLOC_CITY 重庆]的航班。]
蒜茄子怎么做？	[IN:QUERY [SL:DISHNAME 蒜茄子]怎么做？]
大闸蟹的做法。	[IN:QUERY [SL:DISHNAME 大闸蟹]的做法。]
打电话给小女儿	[IN:DIAL 打电话给[SL:NAME 小女儿]]
安徽合力股票	[IN:QUERY [SL:NAME 安徽合力]股票]
说一首唐诗吧！	[IN:QUERY 说一首[SL:DYNASTY 唐]诗吧！]
发条短信给张亚东	[IN:SEND 发条短信给[SL:NAME 张亚东]]
现在温度几度	[IN:QUERY 现在温度几度]
合肥的大润发在哪	[IN:POSITION [SL:LOCATION_CITY 合肥]的[SL:LOCATION_POI 大润发]在哪]
进你的官网	[IN:OPEN 进[SL:NAME 你的官网]]
2013年的警匪电视剧	[IN:QUERY [SL:DATETIME_DATE 2013年]的[SL:TAG 警匪][SL:CATEGORY 电视剧]]
发短信呢	[IN:SEND 发短信呢]
朗读咏雪	[IN:QUERY 朗读[SL:NAME 咏雪]]
晚安的英语	[IN:TRANSLATION [SL:CONTENT 晚安]的[SL:TARGET 英语]]
激动	[IN:OPEN [SL:NAME 激动]]
关于钓鱼岛的新闻进展	[IN:PLAY 关于[SL:KEYWORD 钓鱼岛]的新闻进展]
今天上证指数是几点	[IN:QUERY 今天[SL:NAME 上证指数]是几点]
给徐茶叶发短信	[IN:SEND 给[SL:NAME 徐茶叶]发短信]
今天惠州新闻。	[IN:PLAY [SL:DATETIME_DATE 今天][SL:LOCATION_CITY 惠州]新闻。]
松江钢材城在哪里	[IN:POSITION [SL:LOCATION_POI 松江钢材城]在哪里]
把uc打开啊	[IN:LAUNCH 把[SL:NAME uc]打开啊]
帮我开捕鱼达人	[IN:LAUNCH 帮我开[SL:NAME 捕鱼达人]]
给我背个李白的诗。	[IN:QUERY 给我背个[SL:AUTHOR 李白]的诗。]
秋葵怎么做？	[IN:QUERY [SL:INGREDIENT 秋葵]怎么做？]
打电话	[IN:DIAL 打电话]
发送短信给陈群	[IN:SEND 发送短信给[SL:NAME 陈群]]
帮我订明天早晨的机票	[IN:QUERY 帮我订[SL:STARTDATE_DATE 明天][SL:STARTDATE_TIME 早晨]的机票]
呼叫浦蒲	[IN:DIAL 呼叫[SL:NAME 浦蒲]]
庞军军英语怎么说	[IN:TRANSLATION [SL:CONTENT 庞军军][SL:TARGET 英语]怎么说]
鱼香肉丝肉怎么做？	[IN:QUERY [SL:DISHNAME 鱼香肉丝]肉怎么做？]
海虾的做法。	[IN:QUERY [SL:INGREDIENT 海虾]的做法。]
电影搜索啊！	[IN:QUERY 电影搜索啊！]
美国电影破碎之城	[IN:QUERY [SL:AREA 美国][SL:CATEGORY 电影][SL:NAME 破碎之城]]
帮我查一下赣州到厦门的汽车。	[IN:QUERY 帮我查一下[SL:SRC 赣州]到[SL:DEST 厦门]的汽车。]
中超赛事预告，啊！	[IN:QUERY [SL:CATEGORY 中超]赛事[SL:TYPE 预告]，啊！]
做苹果麦片粥需要哪写材料？	[IN:QUERY 做[SL:DISHNAME 苹果麦片粥]需要哪写材料？]
明天什么节目啊？	[IN:QUERY [SL:DATETIME_DATE 明天]什么[SL:CATEGORY 节目]啊？]
唐代诗人李白。	[IN:QUERY [SL:DYNASTY 唐]代诗人[SL:AUTHOR 李白]。]
到安徽芜湖怎么走	[IN:ROUTE 到[SL:ENDLOC_PROVINCE 安徽][SL:ENDLOC_CITY 芜湖]怎么走]
翻译李淼	[IN:TRANSLATION 翻译[SL:CONTENT 李淼]]
给我念首古诗。	[IN:DEFAULT 给我念首古诗。]
我想转发这封邮件	[IN:FORWARD 我想转发这封邮件]
百度浏览器打开	[IN:LAUNCH [SL:NAME 百度浏览器]打开]
猪舌头怎么做比较啊子？	[IN:QUERY [SL:INGREDIENT 猪舌头]怎么做比较啊子？]
给我来首诗。	[IN:DEFAULT 给我来首诗。]
九江到景德镇的汽车。	[IN:QUERY [SL:SRC 九江]到[SL:DEST 景德镇]的汽车。]
帮我出一个灯谜。	[IN:QUERY 帮我出一个[SL:CATEGORY 灯谜]。]
偏头痛怎么治？	[IN:QUERY [SL:KEYWORD 偏头痛]怎么治？]
萝卜炖排骨汤怎么做？	[IN:QUERY [SL:DISHNAME 萝卜炖排骨汤]怎么做？]
帮我查一下广州到深圳的火车	[IN:QUERY 帮我查一下[SL:STARTLOC_CITY 广州]到[SL:ENDLOC_CITY 深圳]的火车]
土豆粉怎么做好吃？	[IN:QUERY [SL:INGREDIENT 土豆粉]怎么做好吃？]
我想了解地产板块股票现在怎么样	[IN:QUERY 我想了解[SL:NAME 地产板块]股票现在怎么样]
最新的热门电影是什么呀？	[IN:QUERY 最新的热门电影是什么呀？]
给李慧发个短信说我要回家	[IN:SEND 给[SL:NAME 李慧]发个短信说[SL:CONTENT 我要回家]]
导航到奉贤	[IN:ROUTE 导航到[SL:ENDLOC_AREA 奉贤]]
你真笨，是四喜丸子怎么做了。	[IN:QUERY 你真笨，是[SL:DISHNAME 四喜丸子]怎么做了。]
帮我查一下洛阳到赣州的火车	[IN:QUERY 帮我查一下[SL:STARTLOC_CITY 洛阳]到[SL:ENDLOC_CITY 赣州]的火车]
播放最近新闻。	[IN:PLAY 播放[SL:DATETIME_DATE 最近]新闻。]
我要看现代言情小说	[IN:QUERY 我要看[SL:CATEGORY 现代言情]小说]
查找张伟军	[IN:QUERY 查找[SL:NAME 张伟军]]
给严巧发短信	[IN:SEND 给[SL:NAME 严巧]发短信]
朗诵诗词。	[IN:DEFAULT 朗诵诗词。]
零七播报新闻。	[IN:PLAY 零七播报新闻。]
我不明白用英文怎么讲	[IN:TRANSLATION [SL:CONTENT 我不明白]用[SL:TARGET 英文]怎么讲]
泰山石油股票	[IN:QUERY [SL:NAME 泰山石油]股票]
帮我查一下温州到汉中的汽车。	[IN:QUERY 帮我查一下[SL:SRC 温州]到[SL:DEST 汉中]的汽车。]
发短信给王勋连说我很好	[IN:SEND 发短信给[SL:NAME 王勋连]说[SL:CONTENT 我很好]]
中央一一台有什么节目吗	[IN:QUERY [SL:TVCHANNEL 中央一一台]有什么节目吗]
打一个灯谜啊，你。	[IN:QUERY 打一个[SL:CATEGORY 灯谜]啊，你。]
很高兴认识你英语怎么说啊	[IN:TRANSLATION [SL:CONTENT 很高兴认识你][SL:TARGET 英语]怎么说啊]
回看烽火佳人回看安徽卫视烽火佳人	[IN:LOOK_BACK 回看[SL:NAME 烽火佳人]回看[SL:TVCHANNEL 安徽卫视][SL:NAME 烽火佳人]]
把莫若的电话号码发送给反面教材	[IN:SENDCONTACTS 把[SL:NAME 莫若]的电话号码发送给[SL:RECEIVER 反面教材]]
中国制用英文怎么说	[IN:TRANSLATION [SL:CONTENT 中国制]用[SL:TARGET 英文]怎么说]
腐乳肉怎么做？	[IN:QUERY [SL:DISHNAME 腐乳肉]怎么做？]
什么时候有西游记呢？	[IN:QUERY 什么时候有[SL:NAME 西游记]呢？]
念个唐诗给我听。	[IN:QUERY 念个[SL:DYNASTY 唐]诗给我听。]
放首陈奕迅的十年	[IN:PLAY 放首[SL:ARTIST 陈奕迅]的[SL:SONG 十年]]
爱笑会议室什么时候播放	[IN:QUERY [SL:NAME 爱笑会议室]什么时候播放]
热门电影有哪些啊？	[IN:QUERY 热门电影有哪些啊？]
讯飞科技股票价格	[IN:QUERY [SL:NAME 讯飞科技]股票价格]
赵柏田鸡怎么做啊？	[IN:QUERY 赵柏[SL:INGREDIENT 田鸡]怎么做啊？]
明天到佛山的航班	[IN:QUERY [SL:STARTDATE_DATE 明天]到[SL:ENDLOC_CITY 佛山]的航班]
臭豆腐怎么做啊？	[IN:QUERY [SL:DISHNAME 臭豆腐]怎么做啊？]
到贵阳的航班。	[IN:QUERY 到[SL:ENDLOC_CITY 贵阳]的航班。]
放首歌听一下你好	[IN:PLAY 放首歌听一下你好]
CCTV7军事农业	[IN:PLAY [SL:NAME CCTV7军事农业]]
我想听重庆新闻。	[IN:PLAY 我想听[SL:LOCATION_CITY 重庆]新闻。]
广州恒大的赛程。	[IN:QUERY [SL:NAME 广州恒大]的赛程。]
我想听周杰伦的菊花台	[IN:PLAY 我想听[SL:ARTIST 周杰伦]的[SL:SONG 菊花台]]
中国建设银行的行情	[IN:QUERY 中国[SL:NAME 建设银行]的行情]
薛平贵与王宝钏	[IN:QUERY [SL:NAME 薛平贵与王宝钏]]
从从合肥到北京的航班	[IN:QUERY 从从[SL:STARTLOC_CITY 合肥]到[SL:ENDLOC_CITY 北京]的航班]
帮我写一条新邮件	[IN:CREATE 帮我写一条新邮件]
网上最火的小说有哪些	[IN:QUERY 网上[SL:POPULARITY 最火]的小说有哪些]
查询中信国安的股票	[IN:QUERY 查询[SL:NAME 中信国安]的股票]
怎么做鱼呢？	[IN:QUERY 怎么做[SL:INGREDIENT 鱼]呢？]
时间的英文怎么讲	[IN:TRANSLATION [SL:CONTENT 时间]的[SL:TARGET 英文]怎么讲]
来一首剑侠情缘	[IN:PLAY 来一首[SL:SONG 剑侠情缘]]
童子鸡的做法。	[IN:QUERY [SL:INGREDIENT 童子鸡]的做法。]
发信息给健美	[IN:SEND 发信息给[SL:NAME 健美]]
银耳莲子粥怎么做	[IN:QUERY [SL:DISHNAME 银耳莲子粥]怎么做]
发短信给王小露的	[IN:SEND 发短信给[SL:NAME 王小露]的]
帮我发邮件给婷婷	[IN:SEND 帮我发邮件给[SL:NAME 婷婷]]
上海到北京怎么走	[IN:ROUTE [SL:STARTLOC_CITY 上海]到[SL:ENDLOC_CITY 北京]怎么走]
现在有什么好的电视剧。	[IN:QUERY [SL:DATETIME_TIME 现在]有什么好的[SL:CATEGORY 电视剧]。]
搜索烤饼的做法。	[IN:QUERY 搜索[SL:INGREDIENT 烤饼]的做法。]
我想听水墨丹青这首歌	[IN:PLAY 我想听[SL:SONG 水墨丹青]这首歌]
腊鱼头怎么做？	[IN:QUERY [SL:DISHNAME 腊鱼头]怎么做？]
胡萝卜怎么炒好吃？	[IN:QUERY [SL:INGREDIENT 胡萝卜]怎么炒好吃？]
多想听新闻，哦。	[IN:PLAY 多想听新闻，哦。]
我喜欢亚楠用英语怎么说	[IN:TRANSLATION [SL:CONTENT 我喜欢亚楠]用[SL:TARGET 英语]怎么说]
翻译牛	[IN:TRANSLATION 翻译[SL:CONTENT 牛]]
麻烦您能否帮我调频97.1汉中音乐广播电台	[IN:LAUNCH 麻烦您能否帮我调频[SL:CODE 97.1][SL:NAME 汉中音乐广播电台]]
电视台在播什么节目	[IN:QUERY 电视台在播什么节目]
鼻息肉	[IN:QUERY [SL:KEYWORD 鼻息肉]]
15号的我愿意	[IN:QUERY [SL:DATETIME_DATE 15号]的[SL:NAME 我愿意]]
姜堰到南京的火车	[IN:QUERY [SL:STARTLOC_AREA 姜堰]到[SL:ENDLOC_CITY 南京]的火车]
来一首李白的诗。	[IN:QUERY 来一首[SL:AUTHOR 李白]的诗。]
今天晚上有没有中国好声音呢？	[IN:QUERY [SL:DATETIME_DATE 今天][SL:DATETIME_TIME 晚上]有没有[SL:NAME 中国好声音]呢？]
脆瓜。	[IN:QUERY [SL:DISHNAME 脆瓜]。]
类风湿怎么治？	[IN:QUERY [SL:KEYWORD 类风湿]怎么治？]
去枣庄的火车	[IN:QUERY 去[SL:ENDLOC_CITY 枣庄]的火车]
我要听流行歌曲	[IN:PLAY 我要听[SL:CATEGORY 流行]歌曲]
麻辣豆腐怎么做啊？	[IN:QUERY [SL:DISHNAME 麻辣豆腐]怎么做啊？]
搜索京东商城	[IN:QUERY 搜索[SL:NAME 京东商城]]
爱情公约	[IN:QUERY [SL:NAME 爱情公约]]
我要上中学学科网	[IN:OPEN 我要上[SL:NAME 中学学科网]]
高清江苏	[IN:PLAY [SL:RESOLUTION 高清][SL:NAME 江苏]]
明天去徐州的航班	[IN:QUERY [SL:STARTDATE_DATE 明天]去[SL:ENDLOC_CITY 徐州]的航班]
给栾佳佳发短信说回到济南了	[IN:SEND 给[SL:NAME 栾佳佳]发短信说[SL:CONTENT 回到济南了]]
怎么做水煮鱼店？	[IN:QUERY 怎么做[SL:DISHNAME 水煮鱼]店？]
张艺谋的甄嬛传	[IN:QUERY [SL:ARTIST 张艺谋]的[SL:NAME 甄嬛传]]
打电话给郑艺红	[IN:DIAL 打电话给[SL:NAME 郑艺红]]
帮我查一下江西铜业股票	[IN:QUERY 帮我查一下[SL:NAME 江西铜业]股票]
花格等蛋的做法。	[IN:QUERY 花格等[SL:INGREDIENT 蛋]的做法。]
来一首，灵岩。	[IN:QUERY 来一首，[SL:NAME 灵岩]。]
艾莱冈给我点新闻。	[IN:PLAY 艾莱冈给我点新闻。]
鱼香肉丝的做法啊！	[IN:QUERY [SL:DISHNAME 鱼香肉丝]的做法啊！]
给我讲个长篇小说。	[IN:QUERY 给我讲个长篇小说。]
背诵悯农。	[IN:QUERY 背诵[SL:NAME 悯农]。]
我要给陈永信息	[IN:SEND 我要给[SL:NAME 陈永]信息]
热血动漫	[IN:QUERY [SL:TAG 热血][SL:CATEGORY 动漫]]
我要听李白的诗。	[IN:QUERY 我要听[SL:AUTHOR 李白]的诗。]
通宝能源股票	[IN:QUERY [SL:NAME 通宝能源]股票]
鸡爪怎么炒？	[IN:QUERY [SL:INGREDIENT 鸡爪]怎么炒？]
高清中央电视台电影频道	[IN:PLAY [SL:RESOLUTION 高清][SL:NAME 中央电视台电影频道]]
孜然排骨怎么做？	[IN:QUERY [SL:DISHNAME 孜然排骨]怎么做？]
鸡蛋怎么做？	[IN:QUERY [SL:INGREDIENT 鸡蛋]怎么做？]
我要当八路军	[IN:QUERY [SL:NAME 我要当八路军]]
来一个字谜，二。	[IN:QUERY 来一个[SL:CATEGORY 字谜]，二。]
的，酸菜鱼怎么做？怎么？	[IN:QUERY 的，[SL:DISHNAME 酸菜鱼]怎么做？怎么？]
翻译我今天要去打网球	[IN:TRANSLATION 翻译[SL:CONTENT 我今天要去打网球]]
培根金针菇怎么做？	[IN:QUERY [SL:DISHNAME 培根金针菇]怎么做？]
打开节目搜索	[IN:QUERY 打开[SL:CATEGORY 节目]搜索]
智慧树	[IN:QUERY [SL:NAME 智慧树]]
我要看下中央六套	[IN:PLAY 我要看下[SL:NAME 中央六套]]
哦来一首青花瓷	[IN:PLAY 哦来一首[SL:SONG 青花瓷]]
哦来一首传奇	[IN:PLAY 哦来一首[SL:SONG 传奇]]
查寻来宾到柳州的火车	[IN:QUERY 查寻[SL:STARTLOC_CITY 来宾]到[SL:ENDLOC_CITY 柳州]的火车]
钛备份	[IN:LAUNCH [SL:NAME 钛备份]]
帮我查下上海到合肥的火车	[IN:QUERY 帮我查下[SL:STARTLOC_CITY 上海]到[SL:ENDLOC_CITY 合肥]的火车]
发短信方钰玲	[IN:SEND 发短信[SL:NAME 方钰玲]]
帮我查一下赣州到杭州的火车票	[IN:QUERY 帮我查一下[SL:STARTLOC_CITY 赣州]到[SL:ENDLOC_CITY 杭州]的火车票]
给我放一首最炫民族风。	[IN:PLAY 给我放一首[SL:SONG 最炫民族风]。]
教我做馒头。	[IN:QUERY 教我做[SL:DISHNAME 馒头]。]
搜索古诗绝句。	[IN:QUERY 搜索古诗[SL:NAME 绝句]。]
嗯咯鸡爪怎么做的。	[IN:QUERY 嗯咯[SL:INGREDIENT 鸡爪]怎么做的。]
北京二台高清	[IN:PLAY [SL:NAME 北京二台][SL:RESOLUTION 高清]]
八月十九号到成都的航班	[IN:QUERY [SL:STARTDATE_DATE 八月十九号]到[SL:ENDLOC_CITY 成都]的航班]
给石荣福发短信	[IN:SEND 给[SL:NAME 石荣福]发短信]
安阳到郑州的火车	[IN:QUERY [SL:STARTLOC_CITY 安阳]到[SL:ENDLOC_CITY 郑州]的火车]
如何治疗颈椎病。	[IN:QUERY 如何治疗[SL:KEYWORD 颈椎病]。]
打开互联网啦	[IN:OPEN 打开互联网啦]
不懂饭的做法。	[IN:QUERY 不懂[SL:DISHNAME 饭]的做法。]
李白的将进酒。	[IN:QUERY [SL:AUTHOR 李白]的[SL:NAME 将进酒]。]
老马的电话是多少	[IN:QUERY [SL:NAME 老马]的电话是多少]
橙子的英文怎么说	[IN:TRANSLATION [SL:CONTENT 橙子]的[SL:TARGET 英文]怎么说]
南京到厦门的火车票	[IN:QUERY [SL:STARTLOC_CITY 南京]到[SL:ENDLOC_CITY 厦门]的火车票]
帮我找一找龙门飞甲	[IN:QUERY 帮我找一找[SL:NAME 龙门飞甲]]
美国电影敢死队二	[IN:QUERY [SL:AREA 美国][SL:CATEGORY 电影][SL:NAME 敢死队二]]
可不中央五套明天的节目单	[IN:QUERY 可不[SL:TVCHANNEL 中央五套][SL:DATETIME_DATE 明天]的节目单]
播放黑猫警长。	[IN:PLAY 播放[SL:SONG 黑猫警长]。]
导航到石化小学	[IN:ROUTE 导航到[SL:ENDLOC_POI 石化小学]]
讲一个谜语，啊，你，哦。	[IN:QUERY 讲一个[SL:CATEGORY 谜语]，啊，你，哦。]
五用英语怎么说	[IN:TRANSLATION [SL:CONTENT 五]用[SL:TARGET 英语]怎么说]
请帮我打开uc	[IN:LAUNCH 请帮我打开[SL:NAME uc]]
我要听新闻，给我数。	[IN:PLAY 我要听新闻，给我数。]
播放非诚勿扰	[IN:QUERY 播放[SL:NAME 非诚勿扰]]
把李文鼎的号码发给谢服全	[IN:SENDCONTACTS 把[SL:NAME 李文鼎]的号码发给[SL:RECEIVER 谢服全]]
把李志强的号码发给贾洪鉴	[IN:SENDCONTACTS 把[SL:NAME 李志强]的号码发给[SL:RECEIVER 贾洪鉴]]
你好丑用英文怎么说	[IN:TRANSLATION [SL:CONTENT 你好丑]用[SL:TARGET 英文]怎么说]
做红烧肉怎么做？	[IN:QUERY 做[SL:DISHNAME 红烧肉]怎么做？]
查查什么时候放百变大咖秀	[IN:QUERY 查查什么时候放[SL:NAME 百变大咖秀]]
查询东吴证券的股票	[IN:QUERY 查询[SL:NAME 东吴证券]的股票]
潍坊到北京机票明天的	[IN:QUERY [SL:STARTLOC_CITY 潍坊]到[SL:ENDLOC_CITY 北京]机票[SL:STARTDATE_DATE 明天]的]
怎么治疗牛皮癣	[IN:QUERY 怎么治疗[SL:KEYWORD 牛皮癣]]
高清深圳台	[IN:PLAY [SL:RESOLUTION 高清][SL:NAME 深圳台]]
从温州到西安的汽车。	[IN:QUERY 从[SL:SRC 温州]到[SL:DEST 西安]的汽车。]
环球旅游明天有演我爱饭米粒	[IN:QUERY [SL:TVCHANNEL 环球旅游][SL:DATETIME_DATE 明天]有演[SL:NAME 我爱饭米粒]]
我要点新闻。	[IN:PLAY 我要点新闻。]
看看有什么好新闻	[IN:PLAY 看看有什么好新闻]
到郑州火车站	[IN:ROUTE 到[SL:ENDLOC_CITY 郑州][SL:ENDLOC_POI 火车站]]
国际新闻。	[IN:PLAY [SL:CATEGORY 国际]新闻。]
呵呵，背首诗来听。	[IN:DEFAULT 呵呵，背首诗来听。]
搜幕府风云	[IN:QUERY 搜[SL:NAME 幕府风云]]
搜索米聊	[IN:QUERY 搜索[SL:NAME 米聊]]
给我背一首唐诗李白写的	[IN:QUERY 给我背一首[SL:DYNASTY 唐]诗[SL:AUTHOR 李白]写的]
翻译芬兰	[IN:TRANSLATION 翻译[SL:CONTENT 芬兰]]
有没有徐州到洛阳的火车票	[IN:QUERY 有没有[SL:STARTLOC_CITY 徐州]到[SL:ENDLOC_CITY 洛阳]的火车票]
查下李宁公司的股票	[IN:QUERY 查下[SL:NAME 李宁]公司的股票]
帮我翻译一下番茄	[IN:TRANSLATION 帮我翻译一下[SL:CONTENT 番茄]]
糖醋排骨怎么做？好了额，你。	[IN:QUERY [SL:DISHNAME 糖醋排骨]怎么做？好了额，你。]
帮我查一下上一期的大乐透	[IN:NUMBER_QUERY 帮我查一下[SL:RELISSUE 上一期]的[SL:NAME 大乐透]]
请念一首毛泽东诗词。	[IN:QUERY 请念一首[SL:AUTHOR 毛泽东]诗词。]
推理动漫	[IN:QUERY [SL:TAG 推理][SL:CATEGORY 动漫]]
得了灰指甲怎么办呢？	[IN:QUERY 得了[SL:KEYWORD 灰指甲]怎么办呢？]
查询饶雪漫的言情小说	[IN:QUERY 查询[SL:AUTHOR 饶雪漫]的[SL:CATEGORY 言情]小说]
给我搜索唐诗。	[IN:QUERY 给我搜索[SL:DYNASTY 唐]诗。]
播新闻，湖南新闻。	[IN:PLAY 播新闻，[SL:LOCATION_PROVINCE 湖南]新闻。]
如何做煎饼。	[IN:QUERY 如何做[SL:DISHNAME 煎饼]。]
酱油鸡。	[IN:QUERY [SL:DISHNAME 酱油鸡]。]
肉沫茄子，怎么做？	[IN:QUERY [SL:DISHNAME 肉沫茄子]，怎么做？]
查询东方集团的股票	[IN:QUERY 查询[SL:NAME 东方集团]的股票]
大头儿子小头爸爸	[IN:QUERY [SL:NAME 大头儿子小头爸爸]]
查询后天广州到上海的航班	[IN:QUERY 查询[SL:STARTDATE_DATE 后天][SL:STARTLOC_CITY 广州]到[SL:ENDLOC_CITY 上海]的航班]
红烧狮子头怎么做	[IN:QUERY [SL:DISHNAME 红烧狮子头]怎么做]
广州恒大比赛谁赢了。	[IN:QUERY [SL:NAME 广州恒大]比赛谁赢了。]
湖南卫视有什么节目	[IN:QUERY [SL:TVCHANNEL 湖南卫视]有什么节目]
给我查一下最近在播哪些电影	[IN:QUERY 给我查一下最近在播哪些电影]
给爸爸打电话	[IN:DIAL 给[SL:NAME 爸爸]打电话]
找一首歌叫斑马斑马	[IN:SEARCH 找一首歌叫[SL:SONG 斑马斑马]]
贵溪至泉州的火车票	[IN:QUERY [SL:STARTLOC_AREA 贵溪]至[SL:ENDLOC_CITY 泉州]的火车票]
酱茄条做法。	[IN:QUERY [SL:DISHNAME 酱茄条]做法。]
搜索下绿巨人	[IN:QUERY 搜索下[SL:NAME 绿巨人]]
查一下上海到苏州的火车票	[IN:QUERY 查一下[SL:STARTLOC_CITY 上海]到[SL:ENDLOC_CITY 苏州]的火车票]
土豆饼怎么做啊？	[IN:QUERY [SL:DISHNAME 土豆饼]怎么做啊？]
酸菜是怎么做的可以用塑料布。	[IN:QUERY [SL:INGREDIENT 酸菜]是怎么做的可以用塑料布。]
东方台	[IN:PLAY [SL:NAME 东方台]]
来一个灯谜，你。	[IN:QUERY 来一个[SL:CATEGORY 灯谜]，你。]
凯立德	[IN:LAUNCH [SL:NAME 凯立德]]
要看特种兵	[IN:QUERY 要看[SL:NAME 特种兵]]
背将进酒。	[IN:QUERY 背[SL:NAME 将进酒]。]
播放郁可唯的歌	[IN:PLAY 播放[SL:ARTIST 郁可唯]的歌]
武汉理工大学在哪	[IN:POSITION [SL:LOCATION_POI 武汉理工大学]在哪]
she的歌	[IN:PLAY [SL:ARTIST she]的歌]
火车南京到衡水	[IN:QUERY 火车[SL:STARTLOC_CITY 南京]到[SL:ENDLOC_CITY 衡水]]
查七乐彩开奖结果	[IN:NUMBER_QUERY 查[SL:NAME 七乐彩]开奖结果]
帮我查一下宁波到郑州的火车	[IN:QUERY 帮我查一下[SL:STARTLOC_CITY 宁波]到[SL:ENDLOC_CITY 郑州]的火车]
做红烧肉要哪些材料呀！	[IN:QUERY 做[SL:DISHNAME 红烧肉]要哪些材料呀！]
正者无敌	[IN:QUERY [SL:NAME 正者无敌]]
肾炎需要注意什么？	[IN:QUERY [SL:KEYWORD 肾炎]需要注意什么？]
完毕用英文怎么说	[IN:TRANSLATION [SL:CONTENT 完毕]用[SL:TARGET 英文]怎么说]
东方卫视高清频道	[IN:PLAY [SL:NAME 东方卫视][SL:RESOLUTION 高清]频道]
我要听那首最美的时光	[IN:PLAY 我要听那首[SL:SONG 最美的时光]]
来首唐诗小池	[IN:QUERY 来首[SL:DYNASTY 唐]诗[SL:NAME 小池]]
找一下非诚勿扰娱乐节目	[IN:QUERY 找一下[SL:NAME 非诚勿扰][SL:TAG 娱乐][SL:CATEGORY 节目]]
发信息给许路雨	[IN:SEND 发信息给[SL:NAME 许路雨]]
不是我是说我给你猜个谜语吧！	[IN:QUERY 不是我是说我给你猜个[SL:CATEGORY 谜语]吧！]
川崎玫瑰的制作方法	[IN:QUERY 川崎[SL:INGREDIENT 玫瑰]的制作方法]
帮我查一下可乐鸡翅怎么做？	[IN:QUERY 帮我查一下[SL:DISHNAME 可乐鸡翅]怎么做？]
我要看综艺	[IN:QUERY 我要看[SL:TAG 综艺]]
打开qq浏览器	[IN:LAUNCH 打开[SL:NAME qq浏览器]]
学而不厌，下一句是什么？	[IN:QUERY [SL:KEYWORD 学而不厌]，[SL:QUERYFIELD 下一句]是什么？]
给杨燕姐发短信	[IN:SEND 给[SL:NAME 杨燕姐]发短信]
给肥老发信息	[IN:SEND 给[SL:NAME 肥老]发信息]
把孟蕾的电话发给陈姬	[IN:SENDCONTACTS 把[SL:NAME 孟蕾]的电话发给[SL:RECEIVER 陈姬]]
呼叫琳琳	[IN:DIAL 呼叫[SL:NAME 琳琳]]
给李光发短信	[IN:SEND 给[SL:NAME 李光]发短信]
添加一条通讯录姓名张守刚号码是13811725158	[IN:CREATE 添加一条通讯录姓名[SL:NAME 张守刚]号码是[SL:CODE 13811725158]]
面包的配方。	[IN:QUERY [SL:DISHNAME 面包]的配方。]
炸馒头片	[IN:QUERY [SL:DISHNAME 炸馒头片]]
上一期15选5的中奖号码是多少？	[IN:NUMBER_QUERY [SL:RELISSUE 上一期][SL:NAME 15选5]的中奖号码是多少？]
帮我查一下合肥市三孝口在哪里	[IN:POSITION 帮我查一下[SL:LOCATION_CITY 合肥]市[SL:LOCATION_POI 三孝口]在哪里]
拨打陈艾电话	[IN:DIAL 拨打[SL:NAME 陈艾]电话]
给高兴打电话	[IN:DIAL 给[SL:NAME 高兴]打电话]
红烧肉的做法，a。	[IN:QUERY [SL:DISHNAME 红烧肉]的做法，a。]
鸽子，怎么做最好吃？	[IN:QUERY [SL:INGREDIENT 鸽子]，怎么做最好吃？]
打开搜狐微博	[IN:LAUNCH 打开[SL:NAME 搜狐微博]]
呼叫王希	[IN:DIAL 呼叫[SL:NAME 王希]]
后天从深圳到成都的航班	[IN:QUERY [SL:STARTDATE_DATE 后天]从[SL:STARTLOC_CITY 深圳]到[SL:ENDLOC_CITY 成都]的航班]
现在最好看的电影。	[IN:QUERY [SL:DATETIME_DATE 现在]最好看的电影。]
翻译共产党员	[IN:TRANSLATION 翻译[SL:CONTENT 共产党员]]
查询中国石化的股价	[IN:QUERY 查询[SL:NAME 中国石化]的股价]
超级战舰电影	[IN:QUERY [SL:NAME 超级战舰][SL:CATEGORY 电影]]
读新闻听。	[IN:PLAY 读新闻听。]
发短信给张三的186的号码我今天请他吃饭	[IN:SEND 发短信给[SL:NAME 张三]的[SL:HEADNUM 186]的号码[SL:CONTENT 我今天请他吃饭]]
红薯粉的做法，了。	[IN:QUERY [SL:INGREDIENT 红薯粉]的做法，了。]
怎么坐车去广州？	[IN:QUERY 怎么坐车去[SL:DEST 广州]？]
喂我想看电影喂	[IN:QUERY 喂我想看[SL:CATEGORY 电影]喂]
ok好，来首李白的诗词。	[IN:QUERY ok好，来首[SL:AUTHOR 李白]的诗词。]
文艺片	[IN:QUERY [SL:TAG 文艺][SL:CATEGORY 片]]
四川卫视频道的节目单	[IN:QUERY [SL:TVCHANNEL 四川卫视]频道的节目单]
查一下最近有什么电影？	[IN:QUERY 查一下最近有什么电影？]
最近好看的小说	[IN:QUERY 最近[SL:POPULARITY 好看]的小说]
查最近的电影。	[IN:QUERY 查最近的电影。]
替我打开新邮件	[IN:LAUNCH 替我打开新邮件]
西昌到成都的航班	[IN:QUERY [SL:STARTLOC_AREA 西昌]到[SL:ENDLOC_CITY 成都]的航班]
情债	[IN:QUERY [SL:NAME 情债]]
吉林电视台	[IN:PLAY [SL:NAME 吉林电视台]]
八月十一日从厦门飞往上海的航班	[IN:QUERY [SL:STARTDATE_DATE 八月十一日]从[SL:STARTLOC_CITY 厦门]飞往[SL:ENDLOC_CITY 上海]的航班]
做面包的配方。	[IN:QUERY 做[SL:DISHNAME 面包]的配方。]
草虾尾怎样做。	[IN:QUERY 草[SL:INGREDIENT 虾尾]怎样做。]
上海到淮安的飞机	[IN:QUERY [SL:STARTLOC_CITY 上海]到[SL:ENDLOC_CITY 淮安]的飞机]
广州去昆明的火车	[IN:QUERY [SL:STARTLOC_CITY 广州]去[SL:ENDLOC_CITY 昆明]的火车]
给蛋炒饭怎么做？	[IN:QUERY 给[SL:DISHNAME 蛋炒饭]怎么做？]
宁乡到长沙怎么走	[IN:ROUTE [SL:STARTLOC_AREA 宁乡]到[SL:ENDLOC_CITY 长沙]怎么走]
铁板烧怎么做？	[IN:QUERY [SL:DISHNAME 铁板烧]怎么做？]
来一个选秀节目	[IN:QUERY 来一个[SL:TAG 选秀][SL:CATEGORY 节目]]
打豆浆剩下的豆渣怎样做，好吃？	[IN:QUERY 打豆浆剩下的[SL:INGREDIENT 豆渣]怎样做，好吃？]
冰糖葫芦怎么做？你？女子。	[IN:QUERY [SL:DISHNAME 冰糖葫芦]怎么做？你？女子。]
搜索腊梅。	[IN:QUERY 搜索[SL:NAME 腊梅]。]
我看看现在的最新新闻是什么？	[IN:PLAY 我看看[SL:DATETIME_TIME 现在]的[SL:KEYWORD 最新]新闻是什么？]
我正在睡觉用英语怎么说	[IN:TRANSLATION [SL:CONTENT 我正在睡觉]用[SL:TARGET 英语]怎么说]
你知道现在广东卫视在演什么吗？	[IN:QUERY 你知道[SL:DATETIME_TIME 现在][SL:TVCHANNEL 广东卫视]在演什么吗？]
辣酸菜鱼怎么做了。	[IN:QUERY [SL:DISHNAME 辣酸菜][SL:INGREDIENT 鱼]怎么做了。]
福尔摩斯探案集	[IN:QUERY [SL:NAME 福尔摩斯探案集]]
